SCH,LABEL,ADDRESS,GIS_X,GIS_Y,ELDERATE,DARZ_ID,SCHOOL_NAME,TYPE_ID,TYPE_LABEL,AGE_FROM,AGE_TO,LAN_ID,LAN_LABEL,WAITS,CAPACITY,CHILD_COUNT,FREE_SPACE,LANG,NEEDS,all.from.1.to.3,all.from.3.to.inf,slots.from.1.to.3,slots.from.3.to.inf
42,Delfinukas,Vido Maciulevičiaus g. 32,6062079,577517,Karoliniškių,42,Delfinukas,1,"Iki 1,5 metų",0,1.06,1,Lietuvių,42,13,13,0,Lie,,13,0,0,0
123,Vėtrungė,Gardino g. 8,6059622,583920,Rasų,123,Vėtrungė,1,"Iki 1,5 metų",0,1.06,1,Lietuvių,30,21,21,0,Lie,,21,0,0,0
98,Rasa,M. Daukšos g. 15,6060531,583570,Senamiesčio,98,Rasa,1,"Iki 1,5 metų",0,1.06,1,Lietuvių,34,20,18,2,Lie,,20,0,2,0
34,Beržynėlis,Beržyno g. 7A,6061242,580943,Naujamiesčio,34,Beržynėlis,1,"Iki 1,5 metų",0,1.06,1,Lietuvių,36,12,13,-1,Lie,,12,0,-1,0
41,Daigelis,Dariaus ir Girėno g. 14,6059212,582247,Naujininkų,41,Daigelis,1,"Iki 1,5 metų",0,1.06,2,Rusų,,19,18,1,Rus,,19,0,1,0
67,Lašelis,Dzūkų g. 29,6059341,582544,Naujininkų,67,Lašelis,1,"Iki 1,5 metų",0,1.06,2,Rusų,,23,23,0,Rus,,23,0,0,0
39,Coliukė,A. Kojelavičiaus g. 298,6063279,592006,Naujosios Vilnios,39,Coliukė,17,Nuo 1 iki 2 metų,1,2,1,Lietuvių,55,18,18,0,Lie,,18,0,0,0
54,Gintarėlis,Didlaukio g. 35,6066821,581859,Verkių,54,Gintarėlis,3,"Nuo 1,5 iki 3 metų",1.06,3,1,Lietuvių,309,52,52,0,Lie,,52,0,0,0
115,Šermukšnėlė,Didlaukio g. 66,6066405,581924,Verkių,115,Šermukšnėlė,3,"Nuo 1,5 iki 3 metų",1.06,3,1,Lietuvių,243,32,32,0,Lie,,32,0,0,0
115,Šermukšnėlė,Didlaukio g. 66,6066405,581924,Verkių,115,Šermukšnėlė,3,"Nuo 1,5 iki 3 metų",1.06,3,2,Rusų,243,30,30,0,Rus,,30,0,0,0
168,Naujųjų verkių,Popieriaus g. 46A,6070424,586127,Verkių,168,Naujųjų verkių,3,"Nuo 1,5 iki 3 metų",1.06,3,2,Rusų,8,25,25,0,Rus,,25,0,0,0
273,Santariškių,Santariškių g. 27,6070076,582528,Verkių,273,Santariškių,3,"Nuo 1,5 iki 3 metų",1.06,3,1,Lietuvių,343,47,48,-1,Lie,,47,0,-1,0
86,Pasaka,Žirmūnų g. 110,6066164,583842,Žirmūnų,86,Pasaka,3,"Nuo 1,5 iki 3 metų",1.06,3,1,Lietuvių,180,31,31,0,Lie,,31,0,0,0
102,Ramunėlė,Žirmūnų g. 10,6063400,583684,Žirmūnų,102,Ramunėlė,3,"Nuo 1,5 iki 3 metų",1.06,3,2,Rusų,103,30,30,0,Rus,,30,0,0,0
102,Ramunėlė,Žirmūnų g. 10,6063400,583684,Žirmūnų,102,Ramunėlė,3,"Nuo 1,5 iki 3 metų",1.06,3,1,Lietuvių,103,33,33,0,Lie,,33,0,0,0
103,Rūta,Žirmūnų g. 50,6063864,583954,Žirmūnų,103,Rūta,3,"Nuo 1,5 iki 3 metų",1.06,3,1,Lietuvių,143,62,62,0,Lie,,62,0,0,0
110,Smalsučiai,Minties g. 40,6063682,583483,Žirmūnų,110,Smalsučiai,3,"Nuo 1,5 iki 3 metų",1.06,3,1,Lietuvių,158,70,65,5,Lie,,70,0,5,0
112,Spragtukas,Žirmūnų g. 108,6066278,583825,Žirmūnų,112,Spragtukas,3,"Nuo 1,5 iki 3 metų",1.06,3,1,Lietuvių,90,39,39,0,Lie,,39,0,0,0
112,Spragtukas,Žirmūnų g. 108,6066278,583825,Žirmūnų,112,Spragtukas,3,"Nuo 1,5 iki 3 metų",1.06,3,2,Rusų,90,30,30,0,Rus,,30,0,0,0
119,Vaidilutė,Rinktinės g. 29,6063132,583062,Žirmūnų,119,Vaidilutė,3,"Nuo 1,5 iki 3 metų",1.06,3,1,Lietuvių,125,68,67,1,Lie,,68,0,1,0
141,Žirniukas,Verkių g. 17,6064137,582995,Žirmūnų,141,Žirniukas,3,"Nuo 1,5 iki 3 metų",1.06,3,1,Lietuvių,160,32,32,0,Lie,,32,0,0,0
158,Vieversys,Žirmūnų g. 89,6065626,584093,Žirmūnų,158,Vieversys,3,"Nuo 1,5 iki 3 metų",1.06,3,1,Lietuvių,110,63,63,0,Lie,,63,0,0,0
159,Žirmūnėliai,Žirmūnų g. 13,6064686,584179,Žirmūnų,159,Žirmūnėliai,3,"Nuo 1,5 iki 3 metų",1.06,3,1,Lietuvių,137,69,71,-2,Lie,,69,0,-2,0
327,Ąžuolas,Žirmūnų g. 32,6063664,583795,Žirmūnų,327,Ąžuolas,3,"Nuo 1,5 iki 3 metų",1.06,3,1,Lietuvių,170,91,91,0,Lie,,91,0,0,0
45,Drugelis,Rinktinės g. 28A,6062920,582954,Šnipiškių,45,Drugelis,3,"Nuo 1,5 iki 3 metų",1.06,3,1,Lietuvių,144,62,61,1,Lie,,62,0,1,0
91,Pipiras,Krokuvos g. 6A,6062992,582810,Šnipiškių,91,Pipiras,3,"Nuo 1,5 iki 3 metų",1.06,3,1,Lietuvių,135,55,52,3,Lie,,55,0,3,0
93,Pumpurėlis,Kalvarijų g. 186,6064711,582594,Šnipiškių,93,Pumpurėlis,3,"Nuo 1,5 iki 3 metų",1.06,3,1,Lietuvių,150,66,63,3,Lie,,66,0,3,0
140,Žvangutis,Rinktinės g. 38A,6063137,582826,Šnipiškių,140,Žvangutis,3,"Nuo 1,5 iki 3 metų",1.06,3,1,Lietuvių,89,29,29,0,Lie,,29,0,0,0
169,Švelnukas,Žalgirio g. 115,6063870,582480,Šnipiškių,169,Švelnukas,3,"Nuo 1,5 iki 3 metų",1.06,3,1,Lietuvių,108,36,36,0,Lie,,36,0,0,0
49,Gandriukas,Fabijoniškių g. 7,6065778,580283,Fabijoniškių,49,Gandriukas,3,"Nuo 1,5 iki 3 metų",1.06,3,1,Lietuvių,213,79,79,0,Lie,,79,0,0,0
57,Jovarėlis,S. Stanevičiaus g. 21,6065899,580839,Fabijoniškių,57,Jovarėlis,3,"Nuo 1,5 iki 3 metų",1.06,3,1,Lietuvių,195,49,49,0,Lie,,49,0,0,0
59,Karusėlė,Gedvydžių g. 25,6067384,579862,Fabijoniškių,59,Karusėlė,3,"Nuo 1,5 iki 3 metų",1.06,3,2,Rusų,35,68,68,0,Rus,,68,0,0,0
105,Sakalėlis,S. Stanevičiaus g. 86,6066416,580734,Fabijoniškių,105,Sakalėlis,3,"Nuo 1,5 iki 3 metų",1.06,3,1,Lietuvių,198,61,61,0,Lie,,61,0,0,0
120,Vandenis,P. Žadeikos g. 14A,6067055,579871,Fabijoniškių,120,Vandenis,3,"Nuo 1,5 iki 3 metų",1.06,3,1,Lietuvių,218,70,70,0,Lie,,70,0,0,0
125,Vėrinėlis,S. Stanevičiaus g. 68,6066291,580732,Fabijoniškių,125,Vėrinėlis,3,"Nuo 1,5 iki 3 metų",1.06,3,2,Rusų,75,35,35,0,Rus,,35,0,0,0
125,Vėrinėlis,S. Stanevičiaus g. 68,6066291,580732,Fabijoniškių,125,Vėrinėlis,3,"Nuo 1,5 iki 3 metų",1.06,3,1,Lietuvių,75,18,17,1,Lie,,18,0,1,0
37,Bitutė,Paberžės g. 20,6065254,580866,Šeškinės,37,Bitutė,3,"Nuo 1,5 iki 3 metų",1.06,3,1,Lietuvių,106,61,61,0,Lie,,61,0,0,0
51,Gelvonėlis,Gelvonų g. 1,6065015,581076,Šeškinės,51,Gelvonėlis,3,"Nuo 1,5 iki 3 metų",1.06,3,1,Lietuvių,61,32,30,2,Lie,,32,0,2,0
51,Gelvonėlis,Gelvonų g. 1,6065015,581076,Šeškinės,51,Gelvonėlis,3,"Nuo 1,5 iki 3 metų",1.06,3,2,Rusų,61,31,29,2,Rus,,31,0,2,0
62,Kodėlčiukas,Laisvės pr. 59,6065259,579457,Šeškinės,62,Kodėlčiukas,3,"Nuo 1,5 iki 3 metų",1.06,3,1,Lietuvių,114,138,138,0,Lie,,138,0,0,0
79,Ozas,Gelvonų g. 24,6064973,580945,Šeškinės,79,Ozas,3,"Nuo 1,5 iki 3 metų",1.06,3,1,Lietuvių,98,69,64,5,Lie,,69,0,5,0
84,Papartis,Čiobiškio g. 17,6065285,579915,Šeškinės,84,Papartis,3,"Nuo 1,5 iki 3 metų",1.06,3,1,Lietuvių,82,69,69,0,Lie,,69,0,0,0
89,Pelėda,Musninkų g. 10,6065012,579870,Šeškinės,89,Pelėda,3,"Nuo 1,5 iki 3 metų",1.06,3,1,Lietuvių,96,77,77,0,Lie,,77,0,0,0
114,Sveikuolis,Dūkštų g. 14,6064690,580111,Šeškinės,114,Sveikuolis,3,"Nuo 1,5 iki 3 metų",1.06,3,2,Rusų,27,66,65,1,Rus,,66,0,1,0
121,Varpelis,Ukmergės g. 204,6064729,580302,Šeškinės,121,Varpelis,3,"Nuo 1,5 iki 3 metų",1.06,3,1,Lietuvių,85,66,59,7,Lie,,66,0,7,0
47,Eglutė,Miglos g. 3,6063700,580436,Žvėryno,47,Eglutė,3,"Nuo 1,5 iki 3 metų",1.06,3,1,Lietuvių,67,103,98,5,Lie,,103,0,5,0
70,Linelis,A. Mickevičiaus g. 21,6062243,580686,Žvėryno,70,Linelis,3,"Nuo 1,5 iki 3 metų",1.06,3,1,Lietuvių,88,34,33,1,Lie,,34,0,1,0
96,Pušynėlis,Miglos g. 53,6063459,580031,Žvėryno,96,Pušynėlis,3,"Nuo 1,5 iki 3 metų",1.06,3,1,Lietuvių,80,37,37,0,Lie,,37,0,0,0
145,Saulutė,Miglos g. 1,6063793,580537,Žvėryno,145,Saulutė,3,"Nuo 1,5 iki 3 metų",1.06,3,4,Lenkų,17,36,36,0,Len,,36,0,0,0
145,Saulutė,Miglos g. 1,6063793,580537,Žvėryno,145,Saulutė,3,"Nuo 1,5 iki 3 metų",1.06,3,2,Rusų,17,35,35,0,Rus,,35,0,0,0
170,Boružėlė,Latvių g. 40,6062729,580386,Žvėryno,170,Boružėlė,3,"Nuo 1,5 iki 3 metų",1.06,3,1,Lietuvių,158,84,84,0,Lie,,84,0,0,0
31,Aitvaras,Pašilaičių g. 10,6066674,579323,Pašilaičių,31,Aitvaras,3,"Nuo 1,5 iki 3 metų",1.06,3,1,Lietuvių,296,34,34,0,Lie,,34,0,0,0
122,Vėjelis,Gabijos g. 21,6066861,578763,Pašilaičių,122,Vėjelis,3,"Nuo 1,5 iki 3 metų",1.06,3,1,Lietuvių,240,14,14,0,Lie,,14,0,0,0
122,Vėjelis,Gabijos g. 21,6066861,578763,Pašilaičių,122,Vėjelis,3,"Nuo 1,5 iki 3 metų",1.06,3,4,Lenkų,240,37,37,0,Len,,37,0,0,0
131,Žemyna,Žemynos g. 13,6066005,579220,Pašilaičių,131,Žemyna,3,"Nuo 1,5 iki 3 metų",1.06,3,1,Lietuvių,278,70,69,1,Lie,,70,0,1,0
134,Žiedas,Žemynos g. 41,6066420,579182,Pašilaičių,134,Žiedas,3,"Nuo 1,5 iki 3 metų",1.06,3,4,Lenkų,133,23,23,0,Len,,23,0,0,0
134,Žiedas,Žemynos g. 41,6066420,579182,Pašilaičių,134,Žiedas,3,"Nuo 1,5 iki 3 metų",1.06,3,1,Lietuvių,133,35,35,0,Lie,,35,0,0,0
134,Žiedas,Žemynos g. 41,6066420,579182,Pašilaičių,134,Žiedas,3,"Nuo 1,5 iki 3 metų",1.06,3,2,Rusų,133,34,34,0,Rus,,34,0,0,0
163,Gabijėlė,Gabijos g. 1,6066898,579033,Pašilaičių,163,Gabijėlė,3,"Nuo 1,5 iki 3 metų",1.06,3,1,Lietuvių,337,35,37,-2,Lie,,35,0,-2,0
78,Nykštukas,Taikos g. 190,6064340,578266,Justiniškių,78,Nykštukas,3,"Nuo 1,5 iki 3 metų",1.06,3,1,Lietuvių,97,95,95,0,Lie,,95,0,0,0
88,Pasakaitė,Taikos g. 30,6065571,578966,Justiniškių,88,Pasakaitė,3,"Nuo 1,5 iki 3 metų",1.06,3,1,Lietuvių,119,64,64,0,Lie,,64,0,0,0
90,Pelenė,Justiniškių g. 84,6065928,578486,Justiniškių,90,Pelenė,3,"Nuo 1,5 iki 3 metų",1.06,3,2,Rusų,53,60,59,1,Rus,,60,0,1,0
90,Pelenė,Justiniškių g. 84,6065928,578486,Justiniškių,90,Pelenė,3,"Nuo 1,5 iki 3 metų",1.06,3,1,Lietuvių,53,42,41,1,Lie,,42,0,1,0
136,Žilvinėlis,Taikos g. 130,6065108,578345,Justiniškių,136,Žilvinėlis,3,"Nuo 1,5 iki 3 metų",1.06,3,1,Lietuvių,93,56,56,0,Lie,,56,0,0,0
143,Berželis,Taikos g. 187,6064814,578102,Justiniškių,143,Berželis,3,"Nuo 1,5 iki 3 metų",1.06,3,2,Rusų,29,51,53,-2,Rus,,51,0,-2,0
143,Berželis,Taikos g. 187,6064814,578102,Justiniškių,143,Berželis,3,"Nuo 1,5 iki 3 metų",1.06,3,1,Lietuvių,29,0,0,0,Lie,,0,0,0,0
152,Justinukas,Taikos g. 99,6065757,578141,Justiniškių,152,Justinukas,3,"Nuo 1,5 iki 3 metų",1.06,3,1,Lietuvių,109,67,67,0,Lie,,67,0,0,0
164,Saulėgrąža,Taikos g. 31,6065577,579285,Justiniškių,164,Saulėgrąža,3,"Nuo 1,5 iki 3 metų",1.06,3,1,Lietuvių,98,44,44,0,Lie,,44,0,0,0
166,Vilija,Taikos g. 15,6065426,579249,Justiniškių,166,Vilija,3,"Nuo 1,5 iki 3 metų",1.06,3,4,Lenkų,32,63,63,0,Len,,63,0,0,0
58,Jurginėlis,Justiniškių g. 47,6063867,578565,Viršuliškių,58,Jurginėlis,3,"Nuo 1,5 iki 3 metų",1.06,3,1,Lietuvių,128,66,66,0,Lie,,66,0,0,0
94,Puriena,Tujų g. 1,6063771,579356,Viršuliškių,94,Puriena,3,"Nuo 1,5 iki 3 metų",1.06,3,1,Lietuvių,166,68,68,0,Lie,,68,0,0,0
129,Zylutė,Justiniškių g. 45,6063900,578692,Viršuliškių,129,Zylutė,3,"Nuo 1,5 iki 3 metų",1.06,3,2,Rusų,24,26,26,0,Rus,,26,0,0,0
135,Žilvitis,Viršuliškių g. 9,6064823,579066,Viršuliškių,135,Žilvitis,3,"Nuo 1,5 iki 3 metų",1.06,3,1,Lietuvių,113,78,78,0,Lie,,78,0,0,0
377,Gluosnis,Justiniškių g. 65,6064191,578425,Viršuliškių,377,Gluosnis,3,"Nuo 1,5 iki 3 metų",1.06,3,1,Lietuvių,123,58,58,0,Lie,,58,0,0,0
42,Delfinukas,Vido Maciulevičiaus g. 32,6062079,577517,Karoliniškių,42,Delfinukas,3,"Nuo 1,5 iki 3 metų",1.06,3,1,Lietuvių,219,51,51,0,Lie,,51,0,0,0
74,Medynėlis,Algimanto Petro Kavoliuko g. 5,6062825,578008,Karoliniškių,74,Medynėlis,3,"Nuo 1,5 iki 3 metų",1.06,3,1,Lietuvių,230,56,57,-1,Lie,,56,0,-1,0
97,Raktelis,Algimanto Petro Kavoliuko g. 12,6063038,578274,Karoliniškių,97,Raktelis,3,"Nuo 1,5 iki 3 metų",1.06,3,4,Lenkų,32,66,66,0,Len,,66,0,0,0
97,Raktelis,Algimanto Petro Kavoliuko g. 12,6063038,578274,Karoliniškių,97,Raktelis,3,"Nuo 1,5 iki 3 metų",1.06,3,2,Rusų,32,34,34,0,Rus,,34,0,0,0
113,Strazdelis,Igno Šimulionio g. 14,6063215,579213,Karoliniškių,113,Strazdelis,3,"Nuo 1,5 iki 3 metų",1.06,3,1,Lietuvių,193,70,70,0,Lie,,70,0,0,0
147,Šilelis,Sietyno g. 5,6061684,577294,Karoliniškių,147,Šilelis,3,"Nuo 1,5 iki 3 metų",1.06,3,1,Lietuvių,112,32,33,-1,Lie,,32,0,-1,0
147,Šilelis,Sietyno g. 5,6061684,577294,Karoliniškių,147,Šilelis,3,"Nuo 1,5 iki 3 metų",1.06,3,2,Rusų,112,34,34,0,Rus,,34,0,0,0
151,Žiburėlis,Laisvės pr. 46,6063037,578464,Karoliniškių,151,Žiburėlis,3,"Nuo 1,5 iki 3 metų",1.06,3,1,Lietuvių,146,50,50,0,Lie,,50,0,0,0
161,Lokiukas,Igno Šimulionio g. 8,6062788,578971,Karoliniškių,161,Lokiukas,3,"Nuo 1,5 iki 3 metų",1.06,3,2,Rusų,29,30,30,0,Rus,,30,0,0,0
55,Giraitė,Erfurto g. 42,6060492,577795,Lazdynų,55,Giraitė,3,"Nuo 1,5 iki 3 metų",1.06,3,1,Lietuvių,102,72,72,0,Lie,,72,0,0,0
68,Lazdynėlis,Lazdynų g. 36,6059832,578474,Lazdynų,68,Lazdynėlis,3,"Nuo 1,5 iki 3 metų",1.06,3,1,Lietuvių,101,37,36,1,Lie,,37,0,1,0
82,Pakalnutė,Architektų g. 44,6060245,578504,Lazdynų,82,Pakalnutė,3,"Nuo 1,5 iki 3 metų",1.06,3,1,Lietuvių,60,46,46,0,Lie,,46,0,0,0
100,Riešutėlis,Erfurto g. 21,6060722,577783,Lazdynų,100,Riešutėlis,3,"Nuo 1,5 iki 3 metų",1.06,3,1,Lietuvių,121,31,32,-1,Lie,,31,0,-1,0
101,Rytas,Architektų g. 162,6061623,578425,Lazdynų,101,Rytas,3,"Nuo 1,5 iki 3 metų",1.06,3,1,Lietuvių,89,84,83,1,Lie,,84,0,1,0
132,Žemuogėlė,Architektų g. 108,6060702,577330,Lazdynų,132,Žemuogėlė,3,"Nuo 1,5 iki 3 metų",1.06,3,1,Lietuvių,67,58,58,0,Lie,,58,0,0,0
132,Žemuogėlė,Architektų g. 108,6060702,577330,Lazdynų,132,Žemuogėlė,3,"Nuo 1,5 iki 3 metų",1.06,3,2,Rusų,67,30,30,0,Rus,,30,0,0,0
133,Žibutė,Architektų g. 62,6060142,578099,Lazdynų,133,Žibutė,3,"Nuo 1,5 iki 3 metų",1.06,3,1,Lietuvių,92,36,36,0,Lie,,36,0,0,0
156,Obelėlė,Architektų g. 204,6061258,578692,Lazdynų,156,Obelėlė,3,"Nuo 1,5 iki 3 metų",1.06,3,1,Lietuvių,87,76,75,1,Lie,,76,0,1,0
157,Spygliukas,Architektų g. 16,6060560,578449,Lazdynų,157,Spygliukas,3,"Nuo 1,5 iki 3 metų",1.06,3,1,Lietuvių,101,64,64,0,Lie,,64,0,0,0
53,Gilužis,Vydūno g. 11A,6063915,576329,Pilaitės,53,Gilužis,3,"Nuo 1,5 iki 3 metų",1.06,3,1,Lietuvių,209,72,73,-1,Lie,,72,0,-1,0
165,Pilaitukas,I. Kanto al. 7A,6063638,576320,Pilaitės,165,Pilaitukas,3,"Nuo 1,5 iki 3 metų",1.06,3,1,Lietuvių,209,66,66,0,Lie,,66,0,0,0
165,Pilaitukas,I. Kanto al. 7A,6063638,576320,Pilaitės,165,Pilaitukas,3,"Nuo 1,5 iki 3 metų",1.06,3,4,Lenkų,209,24,24,0,Len,,24,0,0,0
32,Atžalėlės,Antakalnio g. 74,6064495,584600,Antakalnio,32,Atžalėlės,3,"Nuo 1,5 iki 3 metų",1.06,3,1,Lietuvių,97,66,64,2,Lie,,66,0,2,0
60,Kaštonas,Antakalnio g. 108,6065166,584743,Antakalnio,60,Kaštonas,3,"Nuo 1,5 iki 3 metų",1.06,3,4,Lenkų,16,36,36,0,Len,,36,0,0,0
60,Kaštonas,Antakalnio g. 108,6065166,584743,Antakalnio,60,Kaštonas,3,"Nuo 1,5 iki 3 metų",1.06,3,2,Rusų,16,22,22,0,Rus,,22,0,0,0
66,Lakštingala,Lakštingalų g. 10,6066921,585208,Antakalnio,66,Lakštingala,3,"Nuo 1,5 iki 3 metų",1.06,3,1,Lietuvių,86,72,72,0,Lie,,72,0,0,0
75,Molinukas,Keramikų g. 34,6066566,588317,Antakalnio,75,Molinukas,3,"Nuo 1,5 iki 3 metų",1.06,3,1,Lietuvių,47,50,50,0,Lie,,50,0,0,0
95,Pušaitė,Bistryčios g. 3,6064071,584954,Antakalnio,95,Pušaitė,3,"Nuo 1,5 iki 3 metų",1.06,3,1,Lietuvių,122,112,111,1,Lie,,112,0,1,0
111,Spindulėlis,Klinikų g. 5,6064324,584673,Antakalnio,111,Spindulėlis,3,"Nuo 1,5 iki 3 metų",1.06,3,1,Lietuvių,82,29,27,2,Lie,,29,0,2,0
127,Voveraitė,Jūratės g. 4A,6063156,584800,Antakalnio,127,Voveraitė,3,"Nuo 1,5 iki 3 metų",1.06,3,1,Lietuvių,86,63,59,4,Lie,,63,0,4,0
138,Žolynėlis,Žolyno g. 44,6064324,586286,Antakalnio,138,Žolynėlis,3,"Nuo 1,5 iki 3 metų",1.06,3,1,Lietuvių,29,40,40,0,Lie,,40,0,0,0
138,Žolynėlis,Žolyno g. 44,6064324,586286,Antakalnio,138,Žolynėlis,23,"Nuo 1,5 iki 6 metų",1.06,6,1,Lietuvių,1,7,7,0,Lie,,7,0,0,0
181,Volungė,Volungės g. 10,6063735,585007,Antakalnio,181,Volungė,3,"Nuo 1,5 iki 3 metų",1.06,3,1,Lietuvių,89,31,31,0,Lie,,31,0,0,0
388,Žolynas,Žolyno g. 45A,6064325,586025,Antakalnio,388,Žolynas,3,"Nuo 1,5 iki 3 metų",1.06,3,1,Lietuvių,72,55,55,0,Lie,,55,0,0,0
39,Coliukė,A. Kojelavičiaus g. 298,6063279,592006,Naujosios Vilnios,39,Coliukė,3,"Nuo 1,5 iki 3 metų",1.06,3,1,Lietuvių,112,25,25,0,Lie,,25,0,0,0
87,Paslaptis,Darželio g. 7,6062328,591333,Naujosios Vilnios,87,Paslaptis,3,"Nuo 1,5 iki 3 metų",1.06,3,2,Rusų,40,33,33,0,Rus,,33,0,0,0
108,Saulėtekis,Genių g. 12,6062344,591681,Naujosios Vilnios,108,Saulėtekis,3,"Nuo 1,5 iki 3 metų",1.06,3,1,Lietuvių,149,49,43,6,Lie,,49,0,6,0
108,Saulėtekis,Genių g. 12,6062344,591681,Naujosios Vilnios,108,Saulėtekis,3,"Nuo 1,5 iki 3 metų",1.06,3,2,Rusų,149,16,15,1,Rus,,16,0,1,0
124,Vilnelė,Pergalės g. 20,6062147,591050,Naujosios Vilnios,124,Vilnelė,3,"Nuo 1,5 iki 3 metų",1.06,3,1,Lietuvių,156,60,59,1,Lie,,60,0,1,0
137,Žiogelis,J. Kolaso g. 15,6060159,587527,Naujosios Vilnios,137,Žiogelis,3,"Nuo 1,5 iki 3 metų",1.06,3,1,Lietuvių,169,71,71,0,Lie,,71,0,0,0
139,Žuvėdra,Parko g. 8A,6062362,591153,Naujosios Vilnios,139,Žuvėdra,3,"Nuo 1,5 iki 3 metų",1.06,3,2,Rusų,44,33,33,0,Rus,,33,0,0,0
139,Žuvėdra,Parko g. 8A,6062362,591153,Naujosios Vilnios,139,Žuvėdra,3,"Nuo 1,5 iki 3 metų",1.06,3,4,Lenkų,44,31,31,0,Len,,31,0,0,0
63,Klevelis,Stadiono g. 5,6059967,583359,Rasų,63,Klevelis,3,"Nuo 1,5 iki 3 metų",1.06,3,2,Rusų,14,31,31,0,Rus,,31,0,0,0
72,Markučiai,Pakraščio g. 15,6060712,585088,Rasų,72,Markučiai,3,"Nuo 1,5 iki 3 metų",1.06,3,1,Lietuvių,80,44,43,1,Lie,,44,0,1,0
123,Vėtrungė,Gardino g. 8,6059622,583920,Rasų,123,Vėtrungė,3,"Nuo 1,5 iki 3 metų",1.06,3,2,Rusų,106,30,29,1,Rus,,30,0,1,0
123,Vėtrungė,Gardino g. 8,6059622,583920,Rasų,123,Vėtrungė,3,"Nuo 1,5 iki 3 metų",1.06,3,1,Lietuvių,106,52,52,0,Lie,,52,0,0,0
56,Gudrutis,Trakų g. 12,6061176,582562,Senamiesčio,56,Gudrutis,3,"Nuo 1,5 iki 3 metų",1.06,3,1,Lietuvių,145,47,46,1,Lie,,47,0,1,0
61,Krivūlė,Lydos g. 5,6060976,582608,Senamiesčio,61,Krivūlė,3,"Nuo 1,5 iki 3 metų",1.06,3,1,Lietuvių,144,32,32,0,Lie,,32,0,0,0
98,Rasa,M. Daukšos g. 15,6060531,583570,Senamiesčio,98,Rasa,3,"Nuo 1,5 iki 3 metų",1.06,3,1,Lietuvių,157,37,31,6,Lie,,37,0,6,0
116,Šypsena,Povilo Višinskio g. 23,6060511,584155,Senamiesčio,116,Šypsena,3,"Nuo 1,5 iki 3 metų",1.06,3,4,Lenkų,6,60,60,0,Len,,60,0,0,0
118,Užupiukas,Filaretų g. 19,6061661,584234,Senamiesčio,118,Užupiukas,3,"Nuo 1,5 iki 3 metų",1.06,3,1,Lietuvių,141,34,34,0,Lie,,34,0,0,0
155,Gėlynas,Gėlių g. 9A,6060442,582724,Senamiesčio,155,Gėlynas,3,"Nuo 1,5 iki 3 metų",1.06,3,1,Lietuvių,73,63,62,1,Lie,,63,0,1,0
34,Beržynėlis,Beržyno g. 7A,6061242,580943,Naujamiesčio,34,Beržynėlis,3,"Nuo 1,5 iki 3 metų",1.06,3,1,Lietuvių,100,34,33,1,Lie,,34,0,1,0
35,Bildukas,Mindaugo g. 7,6061130,582078,Naujamiesčio,35,Bildukas,3,"Nuo 1,5 iki 3 metų",1.06,3,2,Rusų,8,49,47,2,Rus,,49,0,2,0
44,Drevinukas,K. Donelaičio g. 12,6061130,580761,Naujamiesčio,44,Drevinukas,3,"Nuo 1,5 iki 3 metų",1.06,3,1,Lietuvių,100,30,30,0,Lie,,30,0,0,0
50,Geniukų kalvė,Muitinės g. 30,6060904,581368,Naujamiesčio,50,Geniukų kalvė,3,"Nuo 1,5 iki 3 metų",1.06,3,1,Lietuvių,129,65,63,2,Lie,,65,0,2,0
64,Kurpaitė,Birželio 23-iosios g. 6,6060317,581350,Naujamiesčio,64,Kurpaitė,3,"Nuo 1,5 iki 3 metų",1.06,3,2,Rusų,7,28,28,0,Rus,,28,0,0,0
65,Kūlverstukas,Suvalkų g. 6,6061494,581645,Naujamiesčio,65,Kūlverstukas,3,"Nuo 1,5 iki 3 metų",1.06,3,2,Rusų,21,27,26,1,Rus,,27,0,1,0
73,Mažylis,A. Vivulskio g. 8A,6060972,581880,Naujamiesčio,73,Mažylis,3,"Nuo 1,5 iki 3 metų",1.06,3,1,Lietuvių,127,46,45,1,Lie,,46,0,1,0
81,Pagrandukas,Mindaugo g. 15A,6060779,582121,Naujamiesčio,81,Pagrandukas,3,"Nuo 1,5 iki 3 metų",1.06,3,1,Lietuvių,113,33,33,0,Lie,,33,0,0,0
104,Sadutė,Z. Sierakausko g. 28,6061537,581487,Naujamiesčio,104,Sadutė,3,"Nuo 1,5 iki 3 metų",1.06,3,1,Lietuvių,90,35,33,2,Lie,,35,0,2,0
117,Šnekutis,Vytenio g. 41,6060541,581507,Naujamiesčio,117,Šnekutis,3,"Nuo 1,5 iki 3 metų",1.06,3,1,Lietuvių,47,58,57,1,Lie,,58,0,1,0
33,Aušrelė,Gerosios Vilties g. 28,6060144,580536,Vilkpėdės,33,Aušrelė,3,"Nuo 1,5 iki 3 metų",1.06,3,1,Lietuvių,44,67,61,6,Lie,,67,0,6,0
109,Skroblinukas,Skroblų g. 13,6060044,580835,Vilkpėdės,109,Skroblinukas,3,"Nuo 1,5 iki 3 metų",1.06,3,1,Lietuvių,51,99,99,0,Lie,,99,0,0,0
126,Viltenė,Gerosios Vilties g. 7A,6059971,580171,Vilkpėdės,126,Viltenė,3,"Nuo 1,5 iki 3 metų",1.06,3,1,Lietuvių,34,84,84,0,Lie,,84,0,0,0
149,Vaduvos,Vaduvos g. 14A,6056378,577898,Vilkpėdės,149,Vaduvos,3,"Nuo 1,5 iki 3 metų",1.06,3,1,Lietuvių,25,49,49,0,Lie,,49,0,0,0
150,Vilkpėdės,Gerosios Vilties g. 15,6059880,580271,Vilkpėdės,150,Vilkpėdės,3,"Nuo 1,5 iki 3 metų",1.06,3,1,Lietuvių,24,72,72,0,Lie,,72,0,0,0
154,Bangelė,Žemaitės g. 3,6060388,580757,Vilkpėdės,154,Bangelė,3,"Nuo 1,5 iki 3 metų",1.06,3,2,Rusų,17,33,33,0,Rus,,33,0,0,0
154,Bangelė,Žemaitės g. 3,6060388,580757,Vilkpėdės,154,Bangelė,3,"Nuo 1,5 iki 3 metų",1.06,3,4,Lenkų,17,33,33,0,Len,,33,0,0,0
41,Daigelis,Dariaus ir Girėno g. 14,6059212,582247,Naujininkų,41,Daigelis,3,"Nuo 1,5 iki 3 metų",1.06,3,2,Rusų,10,47,44,3,Rus,,47,0,3,0
46,Du gaideliai,Pelesos g. 15,6059555,582659,Naujininkų,46,Du gaideliai,3,"Nuo 1,5 iki 3 metų",1.06,3,1,Lietuvių,55,51,50,1,Lie,,51,0,1,0
52,Gervelė,Dzūkų g. 32,6059430,582938,Naujininkų,52,Gervelė,3,"Nuo 1,5 iki 3 metų",1.06,3,1,Lietuvių,46,25,25,0,Lie,,25,0,0,0
67,Lašelis,Dzūkų g. 29,6059341,582544,Naujininkų,67,Lašelis,3,"Nuo 1,5 iki 3 metų",1.06,3,2,Rusų,20,19,14,5,Rus,,19,0,5,0
69,Liepsnelė,Kapsų g. 7,6059010,582319,Naujininkų,69,Liepsnelė,3,"Nuo 1,5 iki 3 metų",1.06,3,2,Rusų,12,57,54,3,Rus,,57,0,3,0
80,Pabiručiai,Brolių g. 18,6059283,581775,Naujininkų,80,Pabiručiai,3,"Nuo 1,5 iki 3 metų",1.06,3,1,Lietuvių,42,86,86,0,Lie,,86,0,0,0
106,Salininkų,Kalviškių g. 1,6052946,581325,Naujininkų,106,Salininkų,3,"Nuo 1,5 iki 3 metų",1.06,3,1,Lietuvių,33,67,67,0,Lie,,67,0,0,0
130,Želmenėliai,Šaltkalvių g. 30,6058911,581955,Naujininkų,130,Želmenėliai,3,"Nuo 1,5 iki 3 metų",1.06,3,1,Lietuvių,47,90,90,0,Lie,,90,0,0,0
162,Šaltinėlis,Šaltkalvių g. 13,6059207,581916,Naujininkų,162,Šaltinėlis,3,"Nuo 1,5 iki 3 metų",1.06,3,4,Lenkų,26,43,42,1,Len,,43,0,1,0
83,Panerių,Juodšilių g. 10,6055221,576151,Panerių,83,Panerių,3,"Nuo 1,5 iki 3 metų",1.06,3,1,Lietuvių,12,29,28,1,Lie,,29,0,1,0
128,Trakų Vokė,Eduardo Andrė g. 6,6055241,571717,Panerių,128,Trakų Vokė,3,"Nuo 1,5 iki 3 metų",1.06,3,1,Lietuvių,33,41,42,-1,Lie,,41,0,-1,0
71,Lokiuko giraitė,Kovo 11-osios g. 54,6059688,571108,Grigiškių,71,Lokiuko giraitė,3,"Nuo 1,5 iki 3 metų",1.06,3,1,Lietuvių,44,86,86,0,Lie,,86,0,0,0
99,Rugelis,Kovo 11-osios g. 29A,6059755,570487,Grigiškių,99,Rugelis,3,"Nuo 1,5 iki 3 metų",1.06,3,1,Lietuvių,40,62,62,0,Lie,,62,0,0,0
144,Pelėdžiukas,Lentvario g. 1,6060250,569710,Grigiškių,144,Pelėdžiukas,3,"Nuo 1,5 iki 3 metų",1.06,3,1,Lietuvių,53,33,32,1,Lie,,33,0,1,0
40,Čiauškutis,Sausio 13-osios g. 6,6062138,578557,Visos seniūnijos,40,Čiauškutis,3,"Nuo 1,5 iki 3 metų",1.06,3,1,Lietuvių,2,18,18,0,Lie,,18,0,0,0
92,Prie pasakų parko,Loretos Asanavičiūtės g. 7,6061370,577417,Visos seniūnijos,92,Prie pasakų parko,3,"Nuo 1,5 iki 3 metų",1.06,3,4,Lenkų,9,20,17,3,Len,,20,0,3,0
92,Prie pasakų parko,Loretos Asanavičiūtės g. 7,6061370,577417,Visos seniūnijos,92,Prie pasakų parko,3,"Nuo 1,5 iki 3 metų",1.06,3,2,Rusų,9,33,33,0,Rus,,33,0,0,0
102,Ramunėlė,Žirmūnų g. 10,6063400,583684,Žirmūnų,102,Ramunėlė,18,Nuo 2 iki 4 metų,2,4,4,Lenkų,11,36,36,0,Len,,36,0,0,0
112,Spragtukas,Žirmūnų g. 108,6066278,583825,Žirmūnų,112,Spragtukas,20,Nuo 2 iki 6 metų,2,6,4,Lenkų,13,25,25,0,Len,,25,0,0,0
31,Aitvaras,Pašilaičių g. 10,6066674,579323,Pašilaičių,31,Aitvaras,18,Nuo 2 iki 4 metų,2,4,1,Lietuvių,1,20,20,0,Lie,,20,0,0,0
31,Aitvaras,Pašilaičių g. 10,6066674,579323,Pašilaičių,31,Aitvaras,19,Nuo 2 iki 5 metų,2,5,1,Lietuvių,1,66,66,0,Lie,,66,0,0,0
122,Vėjelis,Gabijos g. 21,6066861,578763,Pašilaičių,122,Vėjelis,18,Nuo 2 iki 4 metų,2,4,2,Rusų,36,37,37,0,Rus,,37,0,0,0
129,Zylutė,Justiniškių g. 45,6063900,578692,Viršuliškių,129,Zylutė,18,Nuo 2 iki 4 metų,2,4,4,Lenkų,13,33,33,0,Len,,33,0,0,0
82,Pakalnutė,Architektų g. 44,6060245,578504,Lazdynų,82,Pakalnutė,19,Nuo 2 iki 5 metų,2,5,4,Lenkų,2,26,26,0,Len,,26,0,0,0
188,Lazdynų mokykla,Žėručio g. 4,6060587,578209,Lazdynų,188,Lazdynų mokykla,20,Nuo 2 iki 6 metų,2,6,4,Lenkų,6,23,21,2,Len,,23,0,2,0
188,Lazdynų mokykla,Žėručio g. 4,6060587,578209,Lazdynų,188,Lazdynų mokykla,20,Nuo 2 iki 6 metų,2,6,1,Lietuvių,6,18,18,0,Lie,,18,0,0,0
138,Žolynėlis,Žolyno g. 44,6064324,586286,Antakalnio,138,Žolynėlis,19,Nuo 2 iki 5 metų,2,5,1,Lietuvių,1,7,7,0,Lie,,7,0,0,0
61,Krivūlė,Lydos g. 5,6060976,582608,Senamiesčio,61,Krivūlė,20,Nuo 2 iki 6 metų,2,6,1,Lietuvių,77,26,24,2,Lie,,26,0,2,0
107,Salvija,J. Jasinskio g. 17,6062109,581253,Naujamiesčio,107,Salvija,18,Nuo 2 iki 4 metų,2,4,8,Hebrajų,14,26,24,2,Heb,,26,0,2,0
99,Rugelis,Kovo 11-osios g. 29A,6059755,570487,Grigiškių,99,Rugelis,18,Nuo 2 iki 4 metų,2,4,2,Rusų,32,32,32,0,Rus,,32,0,0,0
99,Rugelis,Kovo 11-osios g. 29A,6059755,570487,Grigiškių,99,Rugelis,18,Nuo 2 iki 4 metų,2,4,1,Lietuvių,32,21,21,0,Lie,,21,0,0,0
99,Rugelis,Kovo 11-osios g. 29A,6059755,570487,Grigiškių,99,Rugelis,20,Nuo 2 iki 6 metų,2,6,4,Lenkų,2,25,23,2,Len,,25,0,2,0
189,VĮ Mažasis Trinapolis mok. 160 Eur,Trinapolio g. 11,6066065,583013,Visos seniūnijos,189,VĮ Mažasis Trinapolis mok. 160 Eur,12,Nuo 2 iki 3 metų,2,3,1,Lietuvių,18,2,2,0,Lie,,2,0,0,0
189,VĮ Mažasis Trinapolis mok. 160 Eur,Trinapolio g. 11,6066065,583013,Visos seniūnijos,189,VĮ Mažasis Trinapolis mok. 160 Eur,18,Nuo 2 iki 4 metų,2,4,1,Lietuvių,21,6,6,0,Lie,,6,0,0,0
54,Gintarėlis,Didlaukio g. 35,6066821,581859,Verkių,54,Gintarėlis,6,Nuo 3 iki 4 metų,3,4,1,Lietuvių,70,67,67,0,Lie,,67,0,0,0
54,Gintarėlis,Didlaukio g. 35,6066821,581859,Verkių,54,Gintarėlis,14,Nuo 3 iki 6 metų,3,6,1,Lietuvių,172,28,28,0,Lie,,28,0,0,0
115,Šermukšnėlė,Didlaukio g. 66,6066405,581924,Verkių,115,Šermukšnėlė,6,Nuo 3 iki 4 metų,3,4,1,Lietuvių,49,72,71,1,Lie,,72,0,1,0
115,Šermukšnėlė,Didlaukio g. 66,6066405,581924,Verkių,115,Šermukšnėlė,10,Nuo 3 iki 5 metų,3,5,2,Rusų,11,24,21,3,Rus,,24,0,3,0
168,Naujųjų verkių,Popieriaus g. 46A,6070424,586127,Verkių,168,Naujųjų verkių,4,Nuo 3 iki 7 metų,3,7,2,Rusų,10,21,21,0,Rus,,21,0,0,0
273,Santariškių,Santariškių g. 27,6070076,582528,Verkių,273,Santariškių,6,Nuo 3 iki 4 metų,3,4,1,Lietuvių,111,98,97,1,Lie,,98,0,1,0
86,Pasaka,Žirmūnų g. 110,6066164,583842,Žirmūnų,86,Pasaka,4,Nuo 3 iki 7 metų,3,7,1,Lietuvių,16,87,86,1,Lie,,87,0,1,0
86,Pasaka,Žirmūnų g. 110,6066164,583842,Žirmūnų,86,Pasaka,6,Nuo 3 iki 4 metų,3,4,1,Lietuvių,22,44,41,3,Lie,,44,0,3,0
102,Ramunėlė,Žirmūnų g. 10,6063400,583684,Žirmūnų,102,Ramunėlė,6,Nuo 3 iki 4 metų,3,4,1,Lietuvių,2,41,38,3,Lie,,41,0,3,0
102,Ramunėlė,Žirmūnų g. 10,6063400,583684,Žirmūnų,102,Ramunėlė,10,Nuo 3 iki 5 metų,3,5,2,Rusų,4,21,21,0,Rus,,21,0,0,0
103,Rūta,Žirmūnų g. 50,6063864,583954,Žirmūnų,103,Rūta,6,Nuo 3 iki 4 metų,3,4,1,Lietuvių,,50,55,-5,Lie,,50,0,-5,0
103,Rūta,Žirmūnų g. 50,6063864,583954,Žirmūnų,103,Rūta,14,Nuo 3 iki 6 metų,3,6,1,Lietuvių,,10,10,0,Lie,,10,0,0,0
110,Smalsučiai,Minties g. 40,6063682,583483,Žirmūnų,110,Smalsučiai,6,Nuo 3 iki 4 metų,3,4,1,Lietuvių,1,65,59,6,Lie,,65,0,6,0
112,Spragtukas,Žirmūnų g. 108,6066278,583825,Žirmūnų,112,Spragtukas,6,Nuo 3 iki 4 metų,3,4,1,Lietuvių,8,22,23,-1,Lie,,22,0,-1,0
112,Spragtukas,Žirmūnų g. 108,6066278,583825,Žirmūnų,112,Spragtukas,6,Nuo 3 iki 4 metų,3,4,2,Rusų,8,19,19,0,Rus,,19,0,0,0
112,Spragtukas,Žirmūnų g. 108,6066278,583825,Žirmūnų,112,Spragtukas,10,Nuo 3 iki 5 metų,3,5,2,Rusų,2,11,8,3,Rus,,11,0,3,0
119,Vaidilutė,Rinktinės g. 29,6063132,583062,Žirmūnų,119,Vaidilutė,6,Nuo 3 iki 4 metų,3,4,1,Lietuvių,1,91,87,4,Lie,,91,0,4,0
119,Vaidilutė,Rinktinės g. 29,6063132,583062,Žirmūnų,119,Vaidilutė,10,Nuo 3 iki 5 metų,3,5,1,Lietuvių,2,27,20,7,Lie,,27,0,7,0
141,Žirniukas,Verkių g. 17,6064137,582995,Žirmūnų,141,Žirniukas,4,Nuo 3 iki 7 metų,3,7,2,Rusų,9,16,16,0,Rus,,16,0,0,0
141,Žirniukas,Verkių g. 17,6064137,582995,Žirmūnų,141,Žirniukas,6,Nuo 3 iki 4 metų,3,4,1,Lietuvių,7,43,42,1,Lie,,43,0,1,0
141,Žirniukas,Verkių g. 17,6064137,582995,Žirmūnų,141,Žirniukas,10,Nuo 3 iki 5 metų,3,5,1,Lietuvių,16,0,0,0,Lie,,0,0,0,0
141,Žirniukas,Verkių g. 17,6064137,582995,Žirmūnų,141,Žirniukas,14,Nuo 3 iki 6 metų,3,6,1,Lietuvių,25,20,20,0,Lie,,20,0,0,0
148,Vaivorykštė,Tuskulėnų g. 42,6063314,583236,Žirmūnų,148,Vaivorykštė,6,Nuo 3 iki 4 metų,3,4,2,Rusų,,88,87,1,Rus,,88,0,1,0
148,Vaivorykštė,Tuskulėnų g. 42,6063314,583236,Žirmūnų,148,Vaivorykštė,10,Nuo 3 iki 5 metų,3,5,2,Rusų,1,11,11,0,Rus,,11,0,0,0
158,Vieversys,Žirmūnų g. 89,6065626,584093,Žirmūnų,158,Vieversys,6,Nuo 3 iki 4 metų,3,4,1,Lietuvių,7,76,74,2,Lie,,76,0,2,0
159,Žirmūnėliai,Žirmūnų g. 13,6064686,584179,Žirmūnų,159,Žirmūnėliai,6,Nuo 3 iki 4 metų,3,4,1,Lietuvių,8,67,61,6,Lie,,67,0,6,0
159,Žirmūnėliai,Žirmūnų g. 13,6064686,584179,Žirmūnų,159,Žirmūnėliai,10,Nuo 3 iki 5 metų,3,5,1,Lietuvių,15,44,44,0,Lie,,44,0,0,0
327,Ąžuolas,Žirmūnų g. 32,6063664,583795,Žirmūnų,327,Ąžuolas,6,Nuo 3 iki 4 metų,3,4,1,Lietuvių,3,117,113,4,Lie,,117,0,4,0
373,Vilniaus Verkių mokykla-daugiafunkcis centras,Verkių g. 62,6065999,583293,Žirmūnų,373,Vilniaus Verkių mokykla-daugiafunkcis centras,4,Nuo 3 iki 7 metų,3,7,1,Lietuvių,1,8,8,0,Lie,,8,0,0,0
45,Drugelis,Rinktinės g. 28A,6062920,582954,Šnipiškių,45,Drugelis,6,Nuo 3 iki 4 metų,3,4,1,Lietuvių,6,22,22,0,Lie,,22,0,0,0
91,Pipiras,Krokuvos g. 6A,6062992,582810,Šnipiškių,91,Pipiras,6,Nuo 3 iki 4 metų,3,4,1,Lietuvių,5,54,53,1,Lie,,54,0,1,0
93,Pumpurėlis,Kalvarijų g. 186,6064711,582594,Šnipiškių,93,Pumpurėlis,6,Nuo 3 iki 4 metų,3,4,1,Lietuvių,29,54,53,1,Lie,,54,0,1,0
93,Pumpurėlis,Kalvarijų g. 186,6064711,582594,Šnipiškių,93,Pumpurėlis,14,Nuo 3 iki 6 metų,3,6,1,Lietuvių,55,19,19,0,Lie,,19,0,0,0
140,Žvangutis,Rinktinės g. 38A,6063137,582826,Šnipiškių,140,Žvangutis,6,Nuo 3 iki 4 metų,3,4,1,Lietuvių,1,49,42,7,Lie,,49,0,7,0
169,Švelnukas,Žalgirio g. 115,6063870,582480,Šnipiškių,169,Švelnukas,4,Nuo 3 iki 7 metų,3,7,1,Lietuvių,26,25,23,2,Lie,,25,0,2,0
169,Švelnukas,Žalgirio g. 115,6063870,582480,Šnipiškių,169,Švelnukas,6,Nuo 3 iki 4 metų,3,4,1,Lietuvių,13,27,27,0,Lie,,27,0,0,0
49,Gandriukas,Fabijoniškių g. 7,6065778,580283,Fabijoniškių,49,Gandriukas,6,Nuo 3 iki 4 metų,3,4,1,Lietuvių,39,47,47,0,Lie,,47,0,0,0
57,Jovarėlis,S. Stanevičiaus g. 21,6065899,580839,Fabijoniškių,57,Jovarėlis,6,Nuo 3 iki 4 metų,3,4,1,Lietuvių,31,57,55,2,Lie,,57,0,2,0
59,Karusėlė,Gedvydžių g. 25,6067384,579862,Fabijoniškių,59,Karusėlė,6,Nuo 3 iki 4 metų,3,4,1,Lietuvių,10,7,7,0,Lie,,7,0,0,0
59,Karusėlė,Gedvydžių g. 25,6067384,579862,Fabijoniškių,59,Karusėlė,6,Nuo 3 iki 4 metų,3,4,2,Rusų,10,36,31,5,Rus,,36,0,5,0
59,Karusėlė,Gedvydžių g. 25,6067384,579862,Fabijoniškių,59,Karusėlė,14,Nuo 3 iki 6 metų,3,6,4,Lenkų,2,21,21,0,Len,,21,0,0,0
105,Sakalėlis,S. Stanevičiaus g. 86,6066416,580734,Fabijoniškių,105,Sakalėlis,6,Nuo 3 iki 4 metų,3,4,1,Lietuvių,37,71,71,0,Lie,,71,0,0,0
105,Sakalėlis,S. Stanevičiaus g. 86,6066416,580734,Fabijoniškių,105,Sakalėlis,14,Nuo 3 iki 6 metų,3,6,1,Lietuvių,2,30,30,0,Lie,,30,0,0,0
120,Vandenis,P. Žadeikos g. 14A,6067055,579871,Fabijoniškių,120,Vandenis,6,Nuo 3 iki 4 metų,3,4,1,Lietuvių,57,116,116,0,Lie,,116,0,0,0
125,Vėrinėlis,S. Stanevičiaus g. 68,6066291,580732,Fabijoniškių,125,Vėrinėlis,6,Nuo 3 iki 4 metų,3,4,2,Rusų,19,27,27,0,Rus,,27,0,0,0
125,Vėrinėlis,S. Stanevičiaus g. 68,6066291,580732,Fabijoniškių,125,Vėrinėlis,6,Nuo 3 iki 4 metų,3,4,1,Lietuvių,19,20,20,0,Lie,,20,0,0,0
125,Vėrinėlis,S. Stanevičiaus g. 68,6066291,580732,Fabijoniškių,125,Vėrinėlis,6,Nuo 3 iki 4 metų,3,4,4,Lenkų,19,23,23,0,Len,,23,0,0,0
125,Vėrinėlis,S. Stanevičiaus g. 68,6066291,580732,Fabijoniškių,125,Vėrinėlis,10,Nuo 3 iki 5 metų,3,5,4,Lenkų,4,24,24,0,Len,,24,0,0,0
37,Bitutė,Paberžės g. 20,6065254,580866,Šeškinės,37,Bitutė,4,Nuo 3 iki 7 metų,3,7,1,Lietuvių,9,19,19,0,Lie,,19,0,0,0
37,Bitutė,Paberžės g. 20,6065254,580866,Šeškinės,37,Bitutė,6,Nuo 3 iki 4 metų,3,4,1,Lietuvių,16,52,51,1,Lie,,52,0,1,0
51,Gelvonėlis,Gelvonų g. 1,6065015,581076,Šeškinės,51,Gelvonėlis,4,Nuo 3 iki 7 metų,3,7,4,Lenkų,2,36,32,4,Len,,36,0,4,0
51,Gelvonėlis,Gelvonų g. 1,6065015,581076,Šeškinės,51,Gelvonėlis,6,Nuo 3 iki 4 metų,3,4,1,Lietuvių,10,29,29,0,Lie,,29,0,0,0
51,Gelvonėlis,Gelvonų g. 1,6065015,581076,Šeškinės,51,Gelvonėlis,6,Nuo 3 iki 4 metų,3,4,2,Rusų,10,30,26,4,Rus,,30,0,4,0
51,Gelvonėlis,Gelvonų g. 1,6065015,581076,Šeškinės,51,Gelvonėlis,10,Nuo 3 iki 5 metų,3,5,2,Rusų,4,25,23,2,Rus,,25,0,2,0
62,Kodėlčiukas,Laisvės pr. 59,6065259,579457,Šeškinės,62,Kodėlčiukas,6,Nuo 3 iki 4 metų,3,4,1,Lietuvių,6,80,80,0,Lie,,80,0,0,0
79,Ozas,Gelvonų g. 24,6064973,580945,Šeškinės,79,Ozas,6,Nuo 3 iki 4 metų,3,4,1,Lietuvių,15,58,52,6,Lie,,58,0,6,0
84,Papartis,Čiobiškio g. 17,6065285,579915,Šeškinės,84,Papartis,6,Nuo 3 iki 4 metų,3,4,1,Lietuvių,6,86,63,23,Lie,,86,0,23,0
89,Pelėda,Musninkų g. 10,6065012,579870,Šeškinės,89,Pelėda,6,Nuo 3 iki 4 metų,3,4,1,Lietuvių,9,52,51,1,Lie,,52,0,1,0
89,Pelėda,Musninkų g. 10,6065012,579870,Šeškinės,89,Pelėda,10,Nuo 3 iki 5 metų,3,5,1,Lietuvių,9,33,30,3,Lie,,33,0,3,0
89,Pelėda,Musninkų g. 10,6065012,579870,Šeškinės,89,Pelėda,14,Nuo 3 iki 6 metų,3,6,1,Lietuvių,1,23,23,0,Lie,,23,0,0,0
114,Sveikuolis,Dūkštų g. 14,6064690,580111,Šeškinės,114,Sveikuolis,6,Nuo 3 iki 4 metų,3,4,2,Rusų,3,52,52,0,Rus,,52,0,0,0
114,Sveikuolis,Dūkštų g. 14,6064690,580111,Šeškinės,114,Sveikuolis,10,Nuo 3 iki 5 metų,3,5,2,Rusų,3,25,22,3,Rus,,25,0,3,0
121,Varpelis,Ukmergės g. 204,6064729,580302,Šeškinės,121,Varpelis,4,Nuo 3 iki 7 metų,3,7,1,Lietuvių,3,31,26,5,Lie,,31,0,5,0
121,Varpelis,Ukmergės g. 204,6064729,580302,Šeškinės,121,Varpelis,6,Nuo 3 iki 4 metų,3,4,1,Lietuvių,11,70,53,17,Lie,,70,0,17,0
121,Varpelis,Ukmergės g. 204,6064729,580302,Šeškinės,121,Varpelis,10,Nuo 3 iki 5 metų,3,5,1,Lietuvių,13,26,23,3,Lie,,26,0,3,0
36,Birutės,Birutės g. 4,6061804,580647,Žvėryno,36,Birutės,10,Nuo 3 iki 5 metų,3,5,1,Lietuvių,4,46,37,9,Lie,,46,0,9,0
47,Eglutė,Miglos g. 3,6063700,580436,Žvėryno,47,Eglutė,4,Nuo 3 iki 7 metų,3,7,1,Lietuvių,2,29,29,0,Lie,,29,0,0,0
47,Eglutė,Miglos g. 3,6063700,580436,Žvėryno,47,Eglutė,6,Nuo 3 iki 4 metų,3,4,1,Lietuvių,5,72,65,7,Lie,,72,0,7,0
47,Eglutė,Miglos g. 3,6063700,580436,Žvėryno,47,Eglutė,10,Nuo 3 iki 5 metų,3,5,1,Lietuvių,7,29,29,0,Lie,,29,0,0,0
70,Linelis,A. Mickevičiaus g. 21,6062243,580686,Žvėryno,70,Linelis,6,Nuo 3 iki 4 metų,3,4,1,Lietuvių,15,22,22,0,Lie,,22,0,0,0
96,Pušynėlis,Miglos g. 53,6063459,580031,Žvėryno,96,Pušynėlis,10,Nuo 3 iki 5 metų,3,5,1,Lietuvių,14,24,25,-1,Lie,,24,0,-1,0
96,Pušynėlis,Miglos g. 53,6063459,580031,Žvėryno,96,Pušynėlis,14,Nuo 3 iki 6 metų,3,6,1,Lietuvių,,26,26,0,Lie,,26,0,0,0
145,Saulutė,Miglos g. 1,6063793,580537,Žvėryno,145,Saulutė,4,Nuo 3 iki 7 metų,3,7,4,Lenkų,1,23,23,0,Len,,23,0,0,0
145,Saulutė,Miglos g. 1,6063793,580537,Žvėryno,145,Saulutė,6,Nuo 3 iki 4 metų,3,4,2,Rusų,4,23,23,0,Rus,,23,0,0,0
145,Saulutė,Miglos g. 1,6063793,580537,Žvėryno,145,Saulutė,10,Nuo 3 iki 5 metų,3,5,4,Lenkų,1,20,19,1,Len,,20,0,1,0
170,Boružėlė,Latvių g. 40,6062729,580386,Žvėryno,170,Boružėlė,6,Nuo 3 iki 4 metų,3,4,1,Lietuvių,21,54,54,0,Lie,,54,0,0,0
31,Aitvaras,Pašilaičių g. 10,6066674,579323,Pašilaičių,31,Aitvaras,6,Nuo 3 iki 4 metų,3,4,1,Lietuvių,53,26,24,2,Lie,,26,0,2,0
31,Aitvaras,Pašilaičių g. 10,6066674,579323,Pašilaičių,31,Aitvaras,14,Nuo 3 iki 6 metų,3,6,1,Lietuvių,1,43,43,0,Lie,,43,0,0,0
122,Vėjelis,Gabijos g. 21,6066861,578763,Pašilaičių,122,Vėjelis,6,Nuo 3 iki 4 metų,3,4,1,Lietuvių,41,20,20,0,Lie,,20,0,0,0
122,Vėjelis,Gabijos g. 21,6066861,578763,Pašilaičių,122,Vėjelis,6,Nuo 3 iki 4 metų,3,4,4,Lenkų,41,23,23,0,Len,,23,0,0,0
131,Žemyna,Žemynos g. 13,6066005,579220,Pašilaičių,131,Žemyna,6,Nuo 3 iki 4 metų,3,4,1,Lietuvių,41,55,55,0,Lie,,55,0,0,0
134,Žiedas,Žemynos g. 41,6066420,579182,Pašilaičių,134,Žiedas,6,Nuo 3 iki 4 metų,3,4,1,Lietuvių,37,43,42,1,Lie,,43,0,1,0
134,Žiedas,Žemynos g. 41,6066420,579182,Pašilaičių,134,Žiedas,10,Nuo 3 iki 5 metų,3,5,2,Rusų,15,25,25,0,Rus,,25,0,0,0
134,Žiedas,Žemynos g. 41,6066420,579182,Pašilaičių,134,Žiedas,14,Nuo 3 iki 6 metų,3,6,4,Lenkų,2,27,27,0,Len,,27,0,0,0
142,Aušra,Medeinos g. 5,6066482,578753,Pašilaičių,142,Aušra,6,Nuo 3 iki 4 metų,3,4,1,Lietuvių,14,45,45,0,Lie,,45,0,0,0
163,Gabijėlė,Gabijos g. 1,6066898,579033,Pašilaičių,163,Gabijėlė,6,Nuo 3 iki 4 metų,3,4,1,Lietuvių,60,100,100,0,Lie,,100,0,0,0
78,Nykštukas,Taikos g. 190,6064340,578266,Justiniškių,78,Nykštukas,6,Nuo 3 iki 4 metų,3,4,1,Lietuvių,3,92,72,20,Lie,,92,0,20,0
88,Pasakaitė,Taikos g. 30,6065571,578966,Justiniškių,88,Pasakaitė,6,Nuo 3 iki 4 metų,3,4,1,Lietuvių,5,30,30,0,Lie,,30,0,0,0
88,Pasakaitė,Taikos g. 30,6065571,578966,Justiniškių,88,Pasakaitė,14,Nuo 3 iki 6 metų,3,6,1,Lietuvių,2,58,58,0,Lie,,58,0,0,0
90,Pelenė,Justiniškių g. 84,6065928,578486,Justiniškių,90,Pelenė,10,Nuo 3 iki 5 metų,3,5,2,Rusų,3,27,26,1,Rus,,27,0,1,0
90,Pelenė,Justiniškių g. 84,6065928,578486,Justiniškių,90,Pelenė,10,Nuo 3 iki 5 metų,3,5,1,Lietuvių,3,54,49,5,Lie,,54,0,5,0
136,Žilvinėlis,Taikos g. 130,6065108,578345,Justiniškių,136,Žilvinėlis,6,Nuo 3 iki 4 metų,3,4,1,Lietuvių,9,88,88,0,Lie,,88,0,0,0
143,Berželis,Taikos g. 187,6064814,578102,Justiniškių,143,Berželis,6,Nuo 3 iki 4 metų,3,4,2,Rusų,3,26,22,4,Rus,,26,0,4,0
152,Justinukas,Taikos g. 99,6065757,578141,Justiniškių,152,Justinukas,6,Nuo 3 iki 4 metų,3,4,1,Lietuvių,,42,42,0,Lie,,42,0,0,0
164,Saulėgrąža,Taikos g. 31,6065577,579285,Justiniškių,164,Saulėgrąža,6,Nuo 3 iki 4 metų,3,4,1,Lietuvių,11,53,53,0,Lie,,53,0,0,0
164,Saulėgrąža,Taikos g. 31,6065577,579285,Justiniškių,164,Saulėgrąža,14,Nuo 3 iki 6 metų,3,6,1,Lietuvių,14,32,25,7,Lie,,32,0,7,0
166,Vilija,Taikos g. 15,6065426,579249,Justiniškių,166,Vilija,6,Nuo 3 iki 4 metų,3,4,4,Lenkų,10,64,62,2,Len,,64,0,2,0
166,Vilija,Taikos g. 15,6065426,579249,Justiniškių,166,Vilija,10,Nuo 3 iki 5 metų,3,5,4,Lenkų,10,22,22,0,Len,,22,0,0,0
166,Vilija,Taikos g. 15,6065426,579249,Justiniškių,166,Vilija,14,Nuo 3 iki 6 metų,3,6,4,Lenkų,11,27,21,6,Len,,27,0,6,0
166,Vilija,Taikos g. 15,6065426,579249,Justiniškių,166,Vilija,14,Nuo 3 iki 6 metų,3,6,2,Rusų,11,20,20,0,Rus,,20,0,0,0
58,Jurginėlis,Justiniškių g. 47,6063867,578565,Viršuliškių,58,Jurginėlis,6,Nuo 3 iki 4 metų,3,4,1,Lietuvių,7,55,55,0,Lie,,55,0,0,0
58,Jurginėlis,Justiniškių g. 47,6063867,578565,Viršuliškių,58,Jurginėlis,10,Nuo 3 iki 5 metų,3,5,1,Lietuvių,8,25,22,3,Lie,,25,0,3,0
58,Jurginėlis,Justiniškių g. 47,6063867,578565,Viršuliškių,58,Jurginėlis,14,Nuo 3 iki 6 metų,3,6,1,Lietuvių,9,29,12,17,Lie,,29,0,17,0
94,Puriena,Tujų g. 1,6063771,579356,Viršuliškių,94,Puriena,6,Nuo 3 iki 4 metų,3,4,1,Lietuvių,,77,74,3,Lie,,77,0,3,0
129,Zylutė,Justiniškių g. 45,6063900,578692,Viršuliškių,129,Zylutė,6,Nuo 3 iki 4 metų,3,4,1,Lietuvių,2,41,31,10,Lie,,41,0,10,0
129,Zylutė,Justiniškių g. 45,6063900,578692,Viršuliškių,129,Zylutė,10,Nuo 3 iki 5 metų,3,5,2,Rusų,,32,31,1,Rus,,32,0,1,0
129,Zylutė,Justiniškių g. 45,6063900,578692,Viršuliškių,129,Zylutė,14,Nuo 3 iki 6 metų,3,6,4,Lenkų,4,17,16,1,Len,,17,0,1,0
135,Žilvitis,Viršuliškių g. 9,6064823,579066,Viršuliškių,135,Žilvitis,6,Nuo 3 iki 4 metų,3,4,1,Lietuvių,10,93,82,11,Lie,,93,0,11,0
377,Gluosnis,Justiniškių g. 65,6064191,578425,Viršuliškių,377,Gluosnis,6,Nuo 3 iki 4 metų,3,4,1,Lietuvių,11,68,67,1,Lie,,68,0,1,0
377,Gluosnis,Justiniškių g. 65,6064191,578425,Viršuliškių,377,Gluosnis,10,Nuo 3 iki 5 metų,3,5,1,Lietuvių,13,49,43,6,Lie,,49,0,6,0
42,Delfinukas,Vido Maciulevičiaus g. 32,6062079,577517,Karoliniškių,42,Delfinukas,6,Nuo 3 iki 4 metų,3,4,1,Lietuvių,14,98,94,4,Lie,,98,0,4,0
42,Delfinukas,Vido Maciulevičiaus g. 32,6062079,577517,Karoliniškių,42,Delfinukas,14,Nuo 3 iki 6 metų,3,6,1,Lietuvių,34,19,19,0,Lie,,19,0,0,0
74,Medynėlis,Algimanto Petro Kavoliuko g. 5,6062825,578008,Karoliniškių,74,Medynėlis,6,Nuo 3 iki 4 metų,3,4,1,Lietuvių,22,66,66,0,Lie,,66,0,0,0
97,Raktelis,Algimanto Petro Kavoliuko g. 12,6063038,578274,Karoliniškių,97,Raktelis,6,Nuo 3 iki 4 metų,3,4,4,Lenkų,4,30,29,1,Len,,30,0,1,0
97,Raktelis,Algimanto Petro Kavoliuko g. 12,6063038,578274,Karoliniškių,97,Raktelis,10,Nuo 3 iki 5 metų,3,5,4,Lenkų,5,23,23,0,Len,,23,0,0,0
97,Raktelis,Algimanto Petro Kavoliuko g. 12,6063038,578274,Karoliniškių,97,Raktelis,14,Nuo 3 iki 6 metų,3,6,2,Rusų,1,29,28,1,Rus,,29,0,1,0
113,Strazdelis,Igno Šimulionio g. 14,6063215,579213,Karoliniškių,113,Strazdelis,6,Nuo 3 iki 4 metų,3,4,1,Lietuvių,24,59,59,0,Lie,,59,0,0,0
113,Strazdelis,Igno Šimulionio g. 14,6063215,579213,Karoliniškių,113,Strazdelis,14,Nuo 3 iki 6 metų,3,6,1,Lietuvių,42,22,22,0,Lie,,22,0,0,0
147,Šilelis,Sietyno g. 5,6061684,577294,Karoliniškių,147,Šilelis,6,Nuo 3 iki 4 metų,3,4,1,Lietuvių,8,28,28,0,Lie,,28,0,0,0
147,Šilelis,Sietyno g. 5,6061684,577294,Karoliniškių,147,Šilelis,6,Nuo 3 iki 4 metų,3,4,2,Rusų,8,29,29,0,Rus,,29,0,0,0
147,Šilelis,Sietyno g. 5,6061684,577294,Karoliniškių,147,Šilelis,14,Nuo 3 iki 6 metų,3,6,4,Lenkų,,21,21,0,Len,,21,0,0,0
151,Žiburėlis,Laisvės pr. 46,6063037,578464,Karoliniškių,151,Žiburėlis,6,Nuo 3 iki 4 metų,3,4,1,Lietuvių,16,19,19,0,Lie,,19,0,0,0
151,Žiburėlis,Laisvės pr. 46,6063037,578464,Karoliniškių,151,Žiburėlis,10,Nuo 3 iki 5 metų,3,5,1,Lietuvių,27,44,23,21,Lie,,44,0,21,0
161,Lokiukas,Igno Šimulionio g. 8,6062788,578971,Karoliniškių,161,Lokiukas,6,Nuo 3 iki 4 metų,3,4,2,Rusų,6,30,30,0,Rus,,30,0,0,0
55,Giraitė,Erfurto g. 42,6060492,577795,Lazdynų,55,Giraitė,6,Nuo 3 iki 4 metų,3,4,1,Lietuvių,1,72,57,15,Lie,,72,0,15,0
55,Giraitė,Erfurto g. 42,6060492,577795,Lazdynų,55,Giraitė,14,Nuo 3 iki 6 metų,3,6,1,Lietuvių,6,14,10,4,Lie,,14,0,4,0
68,Lazdynėlis,Lazdynų g. 36,6059832,578474,Lazdynų,68,Lazdynėlis,6,Nuo 3 iki 4 metų,3,4,1,Lietuvių,15,84,84,0,Lie,,84,0,0,0
82,Pakalnutė,Architektų g. 44,6060245,578504,Lazdynų,82,Pakalnutė,6,Nuo 3 iki 4 metų,3,4,1,Lietuvių,,75,70,5,Lie,,75,0,5,0
82,Pakalnutė,Architektų g. 44,6060245,578504,Lazdynų,82,Pakalnutė,10,Nuo 3 iki 5 metų,3,5,1,Lietuvių,,30,21,9,Lie,,30,0,9,0
100,Riešutėlis,Erfurto g. 21,6060722,577783,Lazdynų,100,Riešutėlis,6,Nuo 3 iki 4 metų,3,4,1,Lietuvių,,70,64,6,Lie,,70,0,6,0
101,Rytas,Architektų g. 162,6061623,578425,Lazdynų,101,Rytas,6,Nuo 3 iki 4 metų,3,4,1,Lietuvių,,64,59,5,Lie,,64,0,5,0
101,Rytas,Architektų g. 162,6061623,578425,Lazdynų,101,Rytas,10,Nuo 3 iki 5 metų,3,5,1,Lietuvių,5,2,1,1,Lie,,2,0,1,0
132,Žemuogėlė,Architektų g. 108,6060702,577330,Lazdynų,132,Žemuogėlė,6,Nuo 3 iki 4 metų,3,4,1,Lietuvių,,24,24,0,Lie,,24,0,0,0
132,Žemuogėlė,Architektų g. 108,6060702,577330,Lazdynų,132,Žemuogėlė,10,Nuo 3 iki 5 metų,3,5,2,Rusų,3,21,21,0,Rus,,21,0,0,0
133,Žibutė,Architektų g. 62,6060142,578099,Lazdynų,133,Žibutė,6,Nuo 3 iki 4 metų,3,4,1,Lietuvių,,43,40,3,Lie,,43,0,3,0
146,Svaja,Architektų g. 210,6061055,578652,Lazdynų,146,Svaja,6,Nuo 3 iki 4 metų,3,4,2,Rusų,2,45,45,0,Rus,,45,0,0,0
156,Obelėlė,Architektų g. 204,6061258,578692,Lazdynų,156,Obelėlė,6,Nuo 3 iki 4 metų,3,4,1,Lietuvių,3,69,69,0,Lie,,69,0,0,0
157,Spygliukas,Architektų g. 16,6060560,578449,Lazdynų,157,Spygliukas,6,Nuo 3 iki 4 metų,3,4,1,Lietuvių,,17,17,0,Lie,,17,0,0,0
157,Spygliukas,Architektų g. 16,6060560,578449,Lazdynų,157,Spygliukas,10,Nuo 3 iki 5 metų,3,5,1,Lietuvių,4,36,29,7,Lie,,36,0,7,0
53,Gilužis,Vydūno g. 11A,6063915,576329,Pilaitės,53,Gilužis,6,Nuo 3 iki 4 metų,3,4,1,Lietuvių,32,69,69,0,Lie,,69,0,0,0
165,Pilaitukas,I. Kanto al. 7A,6063638,576320,Pilaitės,165,Pilaitukas,4,Nuo 3 iki 7 metų,3,7,4,Lenkų,5,20,20,0,Len,,20,0,0,0
165,Pilaitukas,I. Kanto al. 7A,6063638,576320,Pilaitės,165,Pilaitukas,4,Nuo 3 iki 7 metų,3,7,2,Rusų,5,25,25,0,Rus,,25,0,0,0
165,Pilaitukas,I. Kanto al. 7A,6063638,576320,Pilaitės,165,Pilaitukas,6,Nuo 3 iki 4 metų,3,4,1,Lietuvių,33,46,46,0,Lie,,46,0,0,0
32,Atžalėlės,Antakalnio g. 74,6064495,584600,Antakalnio,32,Atžalėlės,4,Nuo 3 iki 7 metų,3,7,1,Lietuvių,6,22,22,0,Lie,,22,0,0,0
32,Atžalėlės,Antakalnio g. 74,6064495,584600,Antakalnio,32,Atžalėlės,6,Nuo 3 iki 4 metų,3,4,1,Lietuvių,1,42,39,3,Lie,,42,0,3,0
32,Atžalėlės,Antakalnio g. 74,6064495,584600,Antakalnio,32,Atžalėlės,14,Nuo 3 iki 6 metų,3,6,1,Lietuvių,6,28,23,5,Lie,,28,0,5,0
60,Kaštonas,Antakalnio g. 108,6065166,584743,Antakalnio,60,Kaštonas,10,Nuo 3 iki 5 metų,3,5,4,Lenkų,,8,8,0,Len,,8,0,0,0
60,Kaštonas,Antakalnio g. 108,6065166,584743,Antakalnio,60,Kaštonas,10,Nuo 3 iki 5 metų,3,5,1,Lietuvių,,22,22,0,Lie,,22,0,0,0
60,Kaštonas,Antakalnio g. 108,6065166,584743,Antakalnio,60,Kaštonas,14,Nuo 3 iki 6 metų,3,6,4,Lenkų,4,25,25,0,Len,,25,0,0,0
60,Kaštonas,Antakalnio g. 108,6065166,584743,Antakalnio,60,Kaštonas,14,Nuo 3 iki 6 metų,3,6,2,Rusų,4,22,22,0,Rus,,22,0,0,0
66,Lakštingala,Lakštingalų g. 10,6066921,585208,Antakalnio,66,Lakštingala,6,Nuo 3 iki 4 metų,3,4,1,Lietuvių,,95,91,4,Lie,,95,0,4,0
75,Molinukas,Keramikų g. 34,6066566,588317,Antakalnio,75,Molinukas,6,Nuo 3 iki 4 metų,3,4,1,Lietuvių,2,20,20,0,Lie,,20,0,0,0
76,Naminukas,Smėlio g. 13,6064063,584574,Antakalnio,76,Naminukas,6,Nuo 3 iki 4 metų,3,4,1,Lietuvių,5,37,31,6,Lie,,37,0,6,0
76,Naminukas,Smėlio g. 13,6064063,584574,Antakalnio,76,Naminukas,10,Nuo 3 iki 5 metų,3,5,1,Lietuvių,8,22,21,1,Lie,,22,0,1,0
95,Pušaitė,Bistryčios g. 3,6064071,584954,Antakalnio,95,Pušaitė,6,Nuo 3 iki 4 metų,3,4,1,Lietuvių,4,44,44,0,Lie,,44,0,0,0
95,Pušaitė,Bistryčios g. 3,6064071,584954,Antakalnio,95,Pušaitė,10,Nuo 3 iki 5 metų,3,5,1,Lietuvių,6,0,0,0,Lie,,0,0,0,0
111,Spindulėlis,Klinikų g. 5,6064324,584673,Antakalnio,111,Spindulėlis,10,Nuo 3 iki 5 metų,3,5,1,Lietuvių,6,24,24,0,Lie,,24,0,0,0
111,Spindulėlis,Klinikų g. 5,6064324,584673,Antakalnio,111,Spindulėlis,14,Nuo 3 iki 6 metų,3,6,1,Lietuvių,7,22,15,7,Lie,,22,0,7,0
127,Voveraitė,Jūratės g. 4A,6063156,584800,Antakalnio,127,Voveraitė,6,Nuo 3 iki 4 metų,3,4,1,Lietuvių,5,76,53,23,Lie,,76,0,23,0
127,Voveraitė,Jūratės g. 4A,6063156,584800,Antakalnio,127,Voveraitė,10,Nuo 3 iki 5 metų,3,5,1,Lietuvių,7,9,0,9,Lie,,9,0,9,0
138,Žolynėlis,Žolyno g. 44,6064324,586286,Antakalnio,138,Žolynėlis,10,Nuo 3 iki 5 metų,3,5,1,Lietuvių,2,74,25,49,Lie,,74,0,49,0
138,Žolynėlis,Žolyno g. 44,6064324,586286,Antakalnio,138,Žolynėlis,14,Nuo 3 iki 6 metų,3,6,1,Lietuvių,,8,7,1,Lie,,8,0,1,0
181,Volungė,Volungės g. 10,6063735,585007,Antakalnio,181,Volungė,6,Nuo 3 iki 4 metų,3,4,1,Lietuvių,4,20,20,0,Lie,,20,0,0,0
181,Volungė,Volungės g. 10,6063735,585007,Antakalnio,181,Volungė,10,Nuo 3 iki 5 metų,3,5,1,Lietuvių,5,66,54,12,Lie,,66,0,12,0
388,Žolynas,Žolyno g. 45A,6064325,586025,Antakalnio,388,Žolynas,6,Nuo 3 iki 4 metų,3,4,1,Lietuvių,4,18,18,0,Lie,,18,0,0,0
388,Žolynas,Žolyno g. 45A,6064325,586025,Antakalnio,388,Žolynas,10,Nuo 3 iki 5 metų,3,5,1,Lietuvių,6,43,43,0,Lie,,43,0,0,0
39,Coliukė,A. Kojelavičiaus g. 298,6063279,592006,Naujosios Vilnios,39,Coliukė,4,Nuo 3 iki 7 metų,3,7,2,Rusų,19,46,45,1,Rus,,46,0,1,0
39,Coliukė,A. Kojelavičiaus g. 298,6063279,592006,Naujosios Vilnios,39,Coliukė,4,Nuo 3 iki 7 metų,3,7,1,Lietuvių,19,21,20,1,Lie,,21,0,1,0
39,Coliukė,A. Kojelavičiaus g. 298,6063279,592006,Naujosios Vilnios,39,Coliukė,4,Nuo 3 iki 7 metų,3,7,4,Lenkų,19,31,25,6,Len,,31,0,6,0
87,Paslaptis,Darželio g. 7,6062328,591333,Naujosios Vilnios,87,Paslaptis,10,Nuo 3 iki 5 metų,3,5,2,Rusų,13,30,30,0,Rus,,30,0,0,0
108,Saulėtekis,Genių g. 12,6062344,591681,Naujosios Vilnios,108,Saulėtekis,6,Nuo 3 iki 4 metų,3,4,1,Lietuvių,20,55,52,3,Lie,,55,0,3,0
108,Saulėtekis,Genių g. 12,6062344,591681,Naujosios Vilnios,108,Saulėtekis,6,Nuo 3 iki 4 metų,3,4,2,Rusų,20,19,19,0,Rus,,19,0,0,0
124,Vilnelė,Pergalės g. 20,6062147,591050,Naujosios Vilnios,124,Vilnelė,6,Nuo 3 iki 4 metų,3,4,1,Lietuvių,18,70,69,1,Lie,,70,0,1,0
137,Žiogelis,J. Kolaso g. 15,6060159,587527,Naujosios Vilnios,137,Žiogelis,4,Nuo 3 iki 7 metų,3,7,4,Lenkų,,26,23,3,Len,,26,0,3,0
137,Žiogelis,J. Kolaso g. 15,6060159,587527,Naujosios Vilnios,137,Žiogelis,6,Nuo 3 iki 4 metų,3,4,1,Lietuvių,22,50,49,1,Lie,,50,0,1,0
139,Žuvėdra,Parko g. 8A,6062362,591153,Naujosios Vilnios,139,Žuvėdra,10,Nuo 3 iki 5 metų,3,5,2,Rusų,21,24,24,0,Rus,,24,0,0,0
139,Žuvėdra,Parko g. 8A,6062362,591153,Naujosios Vilnios,139,Žuvėdra,10,Nuo 3 iki 5 metų,3,5,1,Lietuvių,21,21,22,-1,Lie,,21,0,-1,0
171,Žaliakalnio,Pergalės g. 22,6062066,591084,Naujosios Vilnios,171,Žaliakalnio,6,Nuo 3 iki 4 metų,3,4,4,Lenkų,1,50,49,1,Len,,50,0,1,0
280,Vilnios pagrindinė mokykla,Palydovo g. 29A,6063647,591077,Naujosios Vilnios,280,Vilnios pagrindinė mokykla,6,Nuo 3 iki 4 metų,3,4,1,Lietuvių,3,28,28,0,Lie,,28,0,0,0
280,Vilnios pagrindinė mokykla,Palydovo g. 29A,6063647,591077,Naujosios Vilnios,280,Vilnios pagrindinė mokykla,10,Nuo 3 iki 5 metų,3,5,1,Lietuvių,3,23,0,23,Lie,,23,0,23,0
283,„Atžalyno” mokykla-darželis,Genių g. 25,6062220,591840,Naujosios Vilnios,283,„Atžalyno” mokykla-darželis,6,Nuo 3 iki 4 metų,3,4,1,Lietuvių,3,17,17,0,Lie,,17,0,0,0
283,„Atžalyno” mokykla-darželis,Genių g. 25,6062220,591840,Naujosios Vilnios,283,„Atžalyno” mokykla-darželis,14,Nuo 3 iki 6 metų,3,6,1,Lietuvių,10,24,24,0,Lie,,24,0,0,0
63,Klevelis,Stadiono g. 5,6059967,583359,Rasų,63,Klevelis,4,Nuo 3 iki 7 metų,3,7,1,Lietuvių,3,22,22,0,Lie,,22,0,0,0
63,Klevelis,Stadiono g. 5,6059967,583359,Rasų,63,Klevelis,10,Nuo 3 iki 5 metų,3,5,2,Rusų,2,19,19,0,Rus,,19,0,0,0
72,Markučiai,Pakraščio g. 15,6060712,585088,Rasų,72,Markučiai,6,Nuo 3 iki 4 metų,3,4,1,Lietuvių,5,45,45,0,Lie,,45,0,0,0
123,Vėtrungė,Gardino g. 8,6059622,583920,Rasų,123,Vėtrungė,6,Nuo 3 iki 4 metų,3,4,1,Lietuvių,9,46,46,0,Lie,,46,0,0,0
56,Gudrutis,Trakų g. 12,6061176,582562,Senamiesčio,56,Gudrutis,6,Nuo 3 iki 4 metų,3,4,1,Lietuvių,1,36,29,7,Lie,,36,0,7,0
61,Krivūlė,Lydos g. 5,6060976,582608,Senamiesčio,61,Krivūlė,6,Nuo 3 iki 4 metų,3,4,1,Lietuvių,9,61,59,2,Lie,,61,0,2,0
98,Rasa,M. Daukšos g. 15,6060531,583570,Senamiesčio,98,Rasa,6,Nuo 3 iki 4 metų,3,4,1,Lietuvių,,39,39,0,Lie,,39,0,0,0
98,Rasa,M. Daukšos g. 15,6060531,583570,Senamiesčio,98,Rasa,14,Nuo 3 iki 6 metų,3,6,1,Lietuvių,2,36,36,0,Lie,,36,0,0,0
116,Šypsena,Povilo Višinskio g. 23,6060511,584155,Senamiesčio,116,Šypsena,6,Nuo 3 iki 4 metų,3,4,4,Lenkų,,25,25,0,Len,,25,0,0,0
118,Užupiukas,Filaretų g. 19,6061661,584234,Senamiesčio,118,Užupiukas,6,Nuo 3 iki 4 metų,3,4,1,Lietuvių,2,42,42,0,Lie,,42,0,0,0
118,Užupiukas,Filaretų g. 19,6061661,584234,Senamiesčio,118,Užupiukas,10,Nuo 3 iki 5 metų,3,5,1,Lietuvių,9,63,60,3,Lie,,63,0,3,0
155,Gėlynas,Gėlių g. 9A,6060442,582724,Senamiesčio,155,Gėlynas,6,Nuo 3 iki 4 metų,3,4,1,Lietuvių,3,19,19,0,Lie,,19,0,0,0
34,Beržynėlis,Beržyno g. 7A,6061242,580943,Naujamiesčio,34,Beržynėlis,6,Nuo 3 iki 4 metų,3,4,1,Lietuvių,2,21,29,-8,Lie,,21,0,-8,0
35,Bildukas,Mindaugo g. 7,6061130,582078,Naujamiesčio,35,Bildukas,4,Nuo 3 iki 7 metų,3,7,2,Rusų,3,38,38,0,Rus,,38,0,0,0
44,Drevinukas,K. Donelaičio g. 12,6061130,580761,Naujamiesčio,44,Drevinukas,6,Nuo 3 iki 4 metų,3,4,1,Lietuvių,,68,59,9,Lie,,68,0,9,0
50,Geniukų kalvė,Muitinės g. 30,6060904,581368,Naujamiesčio,50,Geniukų kalvė,6,Nuo 3 iki 4 metų,3,4,1,Lietuvių,1,36,37,-1,Lie,,36,0,-1,0
50,Geniukų kalvė,Muitinės g. 30,6060904,581368,Naujamiesčio,50,Geniukų kalvė,10,Nuo 3 iki 5 metų,3,5,1,Lietuvių,2,70,64,6,Lie,,70,0,6,0
64,Kurpaitė,Birželio 23-iosios g. 6,6060317,581350,Naujamiesčio,64,Kurpaitė,6,Nuo 3 iki 4 metų,3,4,2,Rusų,,23,21,2,Rus,,23,0,2,0
65,Kūlverstukas,Suvalkų g. 6,6061494,581645,Naujamiesčio,65,Kūlverstukas,10,Nuo 3 iki 5 metų,3,5,2,Rusų,5,27,24,3,Rus,,27,0,3,0
73,Mažylis,A. Vivulskio g. 8A,6060972,581880,Naujamiesčio,73,Mažylis,6,Nuo 3 iki 4 metų,3,4,1,Lietuvių,6,26,26,0,Lie,,26,0,0,0
81,Pagrandukas,Mindaugo g. 15A,6060779,582121,Naujamiesčio,81,Pagrandukas,6,Nuo 3 iki 4 metų,3,4,1,Lietuvių,3,29,29,0,Lie,,29,0,0,0
81,Pagrandukas,Mindaugo g. 15A,6060779,582121,Naujamiesčio,81,Pagrandukas,14,Nuo 3 iki 6 metų,3,6,1,Lietuvių,7,20,21,-1,Lie,,20,0,-1,0
104,Sadutė,Z. Sierakausko g. 28,6061537,581487,Naujamiesčio,104,Sadutė,6,Nuo 3 iki 4 metų,3,4,1,Lietuvių,3,22,21,1,Lie,,22,0,1,0
117,Šnekutis,Vytenio g. 41,6060541,581507,Naujamiesčio,117,Šnekutis,10,Nuo 3 iki 5 metų,3,5,1,Lietuvių,,36,31,5,Lie,,36,0,5,0
160,Dainorėliai,Ankštoji g. 11,6062282,581589,Naujamiesčio,160,Dainorėliai,6,Nuo 3 iki 4 metų,3,4,1,Lietuvių,2,67,65,2,Lie,,67,0,2,0
160,Dainorėliai,Ankštoji g. 11,6062282,581589,Naujamiesčio,160,Dainorėliai,14,Nuo 3 iki 6 metų,3,6,1,Lietuvių,3,28,27,1,Lie,,28,0,1,0
33,Aušrelė,Gerosios Vilties g. 28,6060144,580536,Vilkpėdės,33,Aušrelė,6,Nuo 3 iki 4 metų,3,4,1,Lietuvių,2,70,58,12,Lie,,70,0,12,0
109,Skroblinukas,Skroblų g. 13,6060044,580835,Vilkpėdės,109,Skroblinukas,6,Nuo 3 iki 4 metų,3,4,1,Lietuvių,7,42,42,0,Lie,,42,0,0,0
126,Viltenė,Gerosios Vilties g. 7A,6059971,580171,Vilkpėdės,126,Viltenė,6,Nuo 3 iki 4 metų,3,4,1,Lietuvių,2,20,20,0,Lie,,20,0,0,0
126,Viltenė,Gerosios Vilties g. 7A,6059971,580171,Vilkpėdės,126,Viltenė,10,Nuo 3 iki 5 metų,3,5,1,Lietuvių,2,45,36,9,Lie,,45,0,9,0
149,Vaduvos,Vaduvos g. 14A,6056378,577898,Vilkpėdės,149,Vaduvos,6,Nuo 3 iki 4 metų,3,4,1,Lietuvių,7,27,26,1,Lie,,27,0,1,0
150,Vilkpėdės,Gerosios Vilties g. 15,6059880,580271,Vilkpėdės,150,Vilkpėdės,6,Nuo 3 iki 4 metų,3,4,1,Lietuvių,,26,26,0,Lie,,26,0,0,0
154,Bangelė,Žemaitės g. 3,6060388,580757,Vilkpėdės,154,Bangelė,6,Nuo 3 iki 4 metų,3,4,4,Lenkų,,31,27,4,Len,,31,0,4,0
154,Bangelė,Žemaitės g. 3,6060388,580757,Vilkpėdės,154,Bangelė,10,Nuo 3 iki 5 metų,3,5,2,Rusų,1,56,45,11,Rus,,56,0,11,0
154,Bangelė,Žemaitės g. 3,6060388,580757,Vilkpėdės,154,Bangelė,14,Nuo 3 iki 6 metų,3,6,4,Lenkų,,24,23,1,Len,,24,0,1,0
41,Daigelis,Dariaus ir Girėno g. 14,6059212,582247,Naujininkų,41,Daigelis,4,Nuo 3 iki 7 metų,3,7,1,Lietuvių,2,17,16,1,Lie,,17,0,1,0
41,Daigelis,Dariaus ir Girėno g. 14,6059212,582247,Naujininkų,41,Daigelis,4,Nuo 3 iki 7 metų,3,7,2,Rusų,2,20,20,0,Rus,,20,0,0,0
41,Daigelis,Dariaus ir Girėno g. 14,6059212,582247,Naujininkų,41,Daigelis,6,Nuo 3 iki 4 metų,3,4,2,Rusų,3,35,33,2,Rus,,35,0,2,0
41,Daigelis,Dariaus ir Girėno g. 14,6059212,582247,Naujininkų,41,Daigelis,10,Nuo 3 iki 5 metų,3,5,2,Rusų,4,28,28,0,Rus,,28,0,0,0
46,Du gaideliai,Pelesos g. 15,6059555,582659,Naujininkų,46,Du gaideliai,6,Nuo 3 iki 4 metų,3,4,1,Lietuvių,16,22,22,0,Lie,,22,0,0,0
52,Gervelė,Dzūkų g. 32,6059430,582938,Naujininkų,52,Gervelė,4,Nuo 3 iki 7 metų,3,7,2,Rusų,2,20,17,3,Rus,,20,0,3,0
52,Gervelė,Dzūkų g. 32,6059430,582938,Naujininkų,52,Gervelė,6,Nuo 3 iki 4 metų,3,4,1,Lietuvių,12,31,30,1,Lie,,31,0,1,0
52,Gervelė,Dzūkų g. 32,6059430,582938,Naujininkų,52,Gervelė,14,Nuo 3 iki 6 metų,3,6,1,Lietuvių,14,21,17,4,Lie,,21,0,4,0
67,Lašelis,Dzūkų g. 29,6059341,582544,Naujininkų,67,Lašelis,6,Nuo 3 iki 4 metų,3,4,2,Rusų,1,27,27,0,Rus,,27,0,0,0
67,Lašelis,Dzūkų g. 29,6059341,582544,Naujininkų,67,Lašelis,6,Nuo 3 iki 4 metų,3,4,1,Lietuvių,1,23,0,23,Lie,,23,0,23,0
67,Lašelis,Dzūkų g. 29,6059341,582544,Naujininkų,67,Lašelis,10,Nuo 3 iki 5 metų,3,5,2,Rusų,1,23,20,3,Rus,,23,0,3,0
69,Liepsnelė,Kapsų g. 7,6059010,582319,Naujininkų,69,Liepsnelė,6,Nuo 3 iki 4 metų,3,4,1,Lietuvių,6,23,5,18,Lie,,23,0,18,0
69,Liepsnelė,Kapsų g. 7,6059010,582319,Naujininkų,69,Liepsnelė,6,Nuo 3 iki 4 metų,3,4,2,Rusų,6,21,19,2,Rus,,21,0,2,0
69,Liepsnelė,Kapsų g. 7,6059010,582319,Naujininkų,69,Liepsnelė,10,Nuo 3 iki 5 metų,3,5,2,Rusų,8,20,20,0,Rus,,20,0,0,0
69,Liepsnelė,Kapsų g. 7,6059010,582319,Naujininkų,69,Liepsnelė,14,Nuo 3 iki 6 metų,3,6,2,Rusų,8,19,19,0,Rus,,19,0,0,0
80,Pabiručiai,Brolių g. 18,6059283,581775,Naujininkų,80,Pabiručiai,6,Nuo 3 iki 4 metų,3,4,1,Lietuvių,13,49,49,0,Lie,,49,0,0,0
80,Pabiručiai,Brolių g. 18,6059283,581775,Naujininkų,80,Pabiručiai,14,Nuo 3 iki 6 metų,3,6,1,Lietuvių,16,25,20,5,Lie,,25,0,5,0
106,Salininkų,Kalviškių g. 1,6052946,581325,Naujininkų,106,Salininkų,6,Nuo 3 iki 4 metų,3,4,1,Lietuvių,19,27,27,0,Lie,,27,0,0,0
130,Želmenėliai,Šaltkalvių g. 30,6058911,581955,Naujininkų,130,Želmenėliai,6,Nuo 3 iki 4 metų,3,4,1,Lietuvių,11,44,44,0,Lie,,44,0,0,0
130,Želmenėliai,Šaltkalvių g. 30,6058911,581955,Naujininkų,130,Želmenėliai,14,Nuo 3 iki 6 metų,3,6,1,Lietuvių,13,23,20,3,Lie,,23,0,3,0
162,Šaltinėlis,Šaltkalvių g. 13,6059207,581916,Naujininkų,162,Šaltinėlis,4,Nuo 3 iki 7 metų,3,7,2,Rusų,2,16,16,0,Rus,,16,0,0,0
162,Šaltinėlis,Šaltkalvių g. 13,6059207,581916,Naujininkų,162,Šaltinėlis,6,Nuo 3 iki 4 metų,3,4,4,Lenkų,,32,28,4,Len,,32,0,4,0
162,Šaltinėlis,Šaltkalvių g. 13,6059207,581916,Naujininkų,162,Šaltinėlis,10,Nuo 3 iki 5 metų,3,5,4,Lenkų,,26,23,3,Len,,26,0,3,0
311,Vilniaus Naujininkų mokykla,Šaltkalvių g. 32,6058943,581862,Naujininkų,311,Vilniaus Naujininkų mokykla,14,Nuo 3 iki 6 metų,3,6,1,Lietuvių,,26,26,0,Lie,,26,0,0,0
83,Panerių,Juodšilių g. 10,6055221,576151,Panerių,83,Panerių,10,Nuo 3 iki 5 metų,3,5,1,Lietuvių,,23,23,0,Lie,,23,0,0,0
128,Trakų Vokė,Eduardo Andrė g. 6,6055241,571717,Panerių,128,Trakų Vokė,6,Nuo 3 iki 4 metų,3,4,1,Lietuvių,9,30,30,0,Lie,,30,0,0,0
71,Lokiuko giraitė,Kovo 11-osios g. 54,6059688,571108,Grigiškių,71,Lokiuko giraitė,6,Nuo 3 iki 4 metų,3,4,1,Lietuvių,2,75,73,2,Lie,,75,0,2,0
99,Rugelis,Kovo 11-osios g. 29A,6059755,570487,Grigiškių,99,Rugelis,6,Nuo 3 iki 4 metų,3,4,1,Lietuvių,4,19,21,-2,Lie,,19,0,-2,0
144,Pelėdžiukas,Lentvario g. 1,6060250,569710,Grigiškių,144,Pelėdžiukas,6,Nuo 3 iki 4 metų,3,4,1,Lietuvių,,32,27,5,Lie,,32,0,5,0
40,Čiauškutis,Sausio 13-osios g. 6,6062138,578557,Visos seniūnijos,40,Čiauškutis,6,Nuo 3 iki 4 metų,3,4,1,Lietuvių,,21,21,0,Lie,,21,0,0,0
92,Prie pasakų parko,Loretos Asanavičiūtės g. 7,6061370,577417,Visos seniūnijos,92,Prie pasakų parko,4,Nuo 3 iki 7 metų,3,7,4,Lenkų,,30,18,12,Len,,30,0,12,0
92,Prie pasakų parko,Loretos Asanavičiūtės g. 7,6061370,577417,Visos seniūnijos,92,Prie pasakų parko,6,Nuo 3 iki 4 metų,3,4,1,Lietuvių,,23,0,23,Lie,,23,0,23,0
92,Prie pasakų parko,Loretos Asanavičiūtės g. 7,6061370,577417,Visos seniūnijos,92,Prie pasakų parko,10,Nuo 3 iki 5 metų,3,5,4,Lenkų,1,14,11,3,Len,,14,0,3,0
92,Prie pasakų parko,Loretos Asanavičiūtės g. 7,6061370,577417,Visos seniūnijos,92,Prie pasakų parko,10,Nuo 3 iki 5 metų,3,5,2,Rusų,1,39,36,3,Rus,,39,0,3,0
92,Prie pasakų parko,Loretos Asanavičiūtės g. 7,6061370,577417,Visos seniūnijos,92,Prie pasakų parko,14,Nuo 3 iki 6 metų,3,6,2,Rusų,,18,16,2,Rus,,18,0,2,0
153,Aidas,Lakštingalų g. 8,6066829,585334,Visos seniūnijos,153,Aidas,4,Nuo 3 iki 7 metų,3,7,1,Lietuvių,1,21,16,5,Lie,,21,0,5,0
167,Viltis,Igno Šimulionio g. 6,6062722,578819,Visos seniūnijos,167,Viltis,4,Nuo 3 iki 7 metų,3,7,1,Lietuvių,1,10,10,0,Lie,,10,0,0,0
189,VĮ Mažasis Trinapolis mok. 160 Eur,Trinapolio g. 11,6066065,583013,Visos seniūnijos,189,VĮ Mažasis Trinapolis mok. 160 Eur,6,Nuo 3 iki 4 metų,3,4,1,Lietuvių,3,24,23,1,Lie,,24,0,1,0
54,Gintarėlis,Didlaukio g. 35,6066821,581859,Verkių,54,Gintarėlis,7,Nuo 4 iki 5 metų,4,5,1,Lietuvių,67,55,54,1,Lie,,55,0,1,0
115,Šermukšnėlė,Didlaukio g. 66,6066405,581924,Verkių,115,Šermukšnėlė,7,Nuo 4 iki 5 metų,4,5,1,Lietuvių,57,24,24,0,Lie,,24,0,0,0
273,Santariškių,Santariškių g. 27,6070076,582528,Verkių,273,Santariškių,7,Nuo 4 iki 5 metų,4,5,1,Lietuvių,143,31,31,0,Lie,,31,0,0,0
86,Pasaka,Žirmūnų g. 110,6066164,583842,Žirmūnų,86,Pasaka,7,Nuo 4 iki 5 metų,4,5,1,Lietuvių,24,47,48,-1,Lie,,47,0,-1,0
102,Ramunėlė,Žirmūnų g. 10,6063400,583684,Žirmūnų,102,Ramunėlė,7,Nuo 4 iki 5 metų,4,5,1,Lietuvių,1,26,24,2,Lie,,26,0,2,0
102,Ramunėlė,Žirmūnų g. 10,6063400,583684,Žirmūnų,102,Ramunėlė,16,Nuo 4 iki 7 metų,4,7,4,Lenkų,,24,24,0,Len,,24,0,0,0
103,Rūta,Žirmūnų g. 50,6063864,583954,Žirmūnų,103,Rūta,7,Nuo 4 iki 5 metų,4,5,1,Lietuvių,7,44,45,-1,Lie,,44,0,-1,0
110,Smalsučiai,Minties g. 40,6063682,583483,Žirmūnų,110,Smalsučiai,7,Nuo 4 iki 5 metų,4,5,1,Lietuvių,6,66,63,3,Lie,,66,0,3,0
110,Smalsučiai,Minties g. 40,6063682,583483,Žirmūnų,110,Smalsučiai,13,Nuo 4 iki 6 metų,4,6,1,Lietuvių,10,27,25,2,Lie,,27,0,2,0
110,Smalsučiai,Minties g. 40,6063682,583483,Žirmūnų,110,Smalsučiai,16,Nuo 4 iki 7 metų,4,7,1,Lietuvių,10,19,12,7,Lie,,19,0,7,0
112,Spragtukas,Žirmūnų g. 108,6066278,583825,Žirmūnų,112,Spragtukas,7,Nuo 4 iki 5 metų,4,5,1,Lietuvių,9,22,22,0,Lie,,22,0,0,0
112,Spragtukas,Žirmūnų g. 108,6066278,583825,Žirmūnų,112,Spragtukas,7,Nuo 4 iki 5 metų,4,5,2,Rusų,9,22,22,0,Rus,,22,0,0,0
119,Vaidilutė,Rinktinės g. 29,6063132,583062,Žirmūnų,119,Vaidilutė,7,Nuo 4 iki 5 metų,4,5,1,Lietuvių,1,25,25,0,Lie,,25,0,0,0
119,Vaidilutė,Rinktinės g. 29,6063132,583062,Žirmūnų,119,Vaidilutė,13,Nuo 4 iki 6 metų,4,6,1,Lietuvių,1,23,22,1,Lie,,23,0,1,0
141,Žirniukas,Verkių g. 17,6064137,582995,Žirmūnų,141,Žirniukas,7,Nuo 4 iki 5 metų,4,5,1,Lietuvių,9,21,21,0,Lie,,21,0,0,0
141,Žirniukas,Verkių g. 17,6064137,582995,Žirmūnų,141,Žirniukas,16,Nuo 4 iki 7 metų,4,7,2,Rusų,4,3,1,2,Rus,,3,0,2,0
148,Vaivorykštė,Tuskulėnų g. 42,6063314,583236,Žirmūnų,148,Vaivorykštė,7,Nuo 4 iki 5 metų,4,5,2,Rusų,4,49,48,1,Rus,,49,0,1,0
148,Vaivorykštė,Tuskulėnų g. 42,6063314,583236,Žirmūnų,148,Vaivorykštė,13,Nuo 4 iki 6 metų,4,6,2,Rusų,5,36,35,1,Rus,,36,0,1,0
158,Vieversys,Žirmūnų g. 89,6065626,584093,Žirmūnų,158,Vieversys,7,Nuo 4 iki 5 metų,4,5,1,Lietuvių,7,26,23,3,Lie,,26,0,3,0
159,Žirmūnėliai,Žirmūnų g. 13,6064686,584179,Žirmūnų,159,Žirmūnėliai,7,Nuo 4 iki 5 metų,4,5,1,Lietuvių,7,32,28,4,Lie,,32,0,4,0
159,Žirmūnėliai,Žirmūnų g. 13,6064686,584179,Žirmūnų,159,Žirmūnėliai,16,Nuo 4 iki 7 metų,4,7,1,Lietuvių,17,14,13,1,Lie,,14,0,1,0
312,Vilniaus Emilijos Pliaterytės progimnazija,Žirmūnų g. 119,6066489,584012,Žirmūnų,312,Vilniaus Emilijos Pliaterytės progimnazija,16,Nuo 4 iki 7 metų,4,7,1,Lietuvių,5,41,19,22,Lie,,41,0,22,0
327,Ąžuolas,Žirmūnų g. 32,6063664,583795,Žirmūnų,327,Ąžuolas,7,Nuo 4 iki 5 metų,4,5,1,Lietuvių,5,52,52,0,Lie,,52,0,0,0
45,Drugelis,Rinktinės g. 28A,6062920,582954,Šnipiškių,45,Drugelis,7,Nuo 4 iki 5 metų,4,5,1,Lietuvių,5,22,22,0,Lie,,22,0,0,0
91,Pipiras,Krokuvos g. 6A,6062992,582810,Šnipiškių,91,Pipiras,7,Nuo 4 iki 5 metų,4,5,1,Lietuvių,7,44,43,1,Lie,,44,0,1,0
93,Pumpurėlis,Kalvarijų g. 186,6064711,582594,Šnipiškių,93,Pumpurėlis,7,Nuo 4 iki 5 metų,4,5,1,Lietuvių,13,49,48,1,Lie,,49,0,1,0
140,Žvangutis,Rinktinės g. 38A,6063137,582826,Šnipiškių,140,Žvangutis,7,Nuo 4 iki 5 metų,4,5,1,Lietuvių,1,25,24,1,Lie,,25,0,1,0
169,Švelnukas,Žalgirio g. 115,6063870,582480,Šnipiškių,169,Švelnukas,7,Nuo 4 iki 5 metų,4,5,1,Lietuvių,7,25,24,1,Lie,,25,0,1,0
339,Vilniaus Vladislavo Sirokomlės gimnazija,Linkmenų g. 8,6063489,581831,Šnipiškių,339,Vilniaus Vladislavo Sirokomlės gimnazija,16,Nuo 4 iki 7 metų,4,7,4,Lenkų,1,18,3,15,Len,,18,0,15,0
49,Gandriukas,Fabijoniškių g. 7,6065778,580283,Fabijoniškių,49,Gandriukas,7,Nuo 4 iki 5 metų,4,5,1,Lietuvių,34,62,62,0,Lie,,62,0,0,0
57,Jovarėlis,S. Stanevičiaus g. 21,6065899,580839,Fabijoniškių,57,Jovarėlis,7,Nuo 4 iki 5 metų,4,5,1,Lietuvių,35,56,54,2,Lie,,56,0,2,0
59,Karusėlė,Gedvydžių g. 25,6067384,579862,Fabijoniškių,59,Karusėlė,7,Nuo 4 iki 5 metų,4,5,1,Lietuvių,15,22,22,0,Lie,,22,0,0,0
59,Karusėlė,Gedvydžių g. 25,6067384,579862,Fabijoniškių,59,Karusėlė,7,Nuo 4 iki 5 metų,4,5,2,Rusų,15,27,25,2,Rus,,27,0,2,0
59,Karusėlė,Gedvydžių g. 25,6067384,579862,Fabijoniškių,59,Karusėlė,13,Nuo 4 iki 6 metų,4,6,1,Lietuvių,16,45,42,3,Lie,,45,0,3,0
105,Sakalėlis,S. Stanevičiaus g. 86,6066416,580734,Fabijoniškių,105,Sakalėlis,7,Nuo 4 iki 5 metų,4,5,1,Lietuvių,31,22,22,0,Lie,,22,0,0,0
120,Vandenis,P. Žadeikos g. 14A,6067055,579871,Fabijoniškių,120,Vandenis,7,Nuo 4 iki 5 metų,4,5,1,Lietuvių,36,24,24,0,Lie,,24,0,0,0
125,Vėrinėlis,S. Stanevičiaus g. 68,6066291,580732,Fabijoniškių,125,Vėrinėlis,7,Nuo 4 iki 5 metų,4,5,2,Rusų,26,23,23,0,Rus,,23,0,0,0
125,Vėrinėlis,S. Stanevičiaus g. 68,6066291,580732,Fabijoniškių,125,Vėrinėlis,7,Nuo 4 iki 5 metų,4,5,1,Lietuvių,26,21,21,0,Lie,,21,0,0,0
125,Vėrinėlis,S. Stanevičiaus g. 68,6066291,580732,Fabijoniškių,125,Vėrinėlis,13,Nuo 4 iki 6 metų,4,6,2,Rusų,35,19,19,0,Rus,,19,0,0,0
125,Vėrinėlis,S. Stanevičiaus g. 68,6066291,580732,Fabijoniškių,125,Vėrinėlis,13,Nuo 4 iki 6 metų,4,6,1,Lietuvių,35,20,20,0,Lie,,20,0,0,0
125,Vėrinėlis,S. Stanevičiaus g. 68,6066291,580732,Fabijoniškių,125,Vėrinėlis,16,Nuo 4 iki 7 metų,4,7,2,Rusų,4,22,19,3,Rus,,22,0,3,0
380,Vilniaus Ateities mokykla,S. Stanevičiaus g. 98,6066603,580657,Fabijoniškių,380,Vilniaus Ateities mokykla,16,Nuo 4 iki 7 metų,4,7,2,Rusų,2,18,7,11,Rus,,18,0,11,0
37,Bitutė,Paberžės g. 20,6065254,580866,Šeškinės,37,Bitutė,7,Nuo 4 iki 5 metų,4,5,1,Lietuvių,4,42,42,0,Lie,,42,0,0,0
51,Gelvonėlis,Gelvonų g. 1,6065015,581076,Šeškinės,51,Gelvonėlis,7,Nuo 4 iki 5 metų,4,5,1,Lietuvių,3,24,22,2,Lie,,24,0,2,0
51,Gelvonėlis,Gelvonų g. 1,6065015,581076,Šeškinės,51,Gelvonėlis,16,Nuo 4 iki 7 metų,4,7,2,Rusų,,24,18,6,Rus,,24,0,6,0
62,Kodėlčiukas,Laisvės pr. 59,6065259,579457,Šeškinės,62,Kodėlčiukas,7,Nuo 4 iki 5 metų,4,5,1,Lietuvių,1,63,63,0,Lie,,63,0,0,0
79,Ozas,Gelvonų g. 24,6064973,580945,Šeškinės,79,Ozas,7,Nuo 4 iki 5 metų,4,5,1,Lietuvių,5,72,72,0,Lie,,72,0,0,0
84,Papartis,Čiobiškio g. 17,6065285,579915,Šeškinės,84,Papartis,7,Nuo 4 iki 5 metų,4,5,1,Lietuvių,1,44,44,0,Lie,,44,0,0,0
89,Pelėda,Musninkų g. 10,6065012,579870,Šeškinės,89,Pelėda,7,Nuo 4 iki 5 metų,4,5,1,Lietuvių,,24,24,0,Lie,,24,0,0,0
114,Sveikuolis,Dūkštų g. 14,6064690,580111,Šeškinės,114,Sveikuolis,7,Nuo 4 iki 5 metų,4,5,2,Rusų,,21,21,0,Rus,,21,0,0,0
114,Sveikuolis,Dūkštų g. 14,6064690,580111,Šeškinės,114,Sveikuolis,13,Nuo 4 iki 6 metų,4,6,2,Rusų,,18,18,0,Rus,,18,0,0,0
114,Sveikuolis,Dūkštų g. 14,6064690,580111,Šeškinės,114,Sveikuolis,16,Nuo 4 iki 7 metų,4,7,2,Rusų,,20,11,9,Rus,,20,0,9,0
121,Varpelis,Ukmergės g. 204,6064729,580302,Šeškinės,121,Varpelis,7,Nuo 4 iki 5 metų,4,5,1,Lietuvių,2,47,46,1,Lie,,47,0,1,0
384,Vilniaus Maironio progimnazija,Čiobiškio g. 1,6064950,579723,Šeškinės,384,Vilniaus Maironio progimnazija,16,Nuo 4 iki 7 metų,4,7,1,Lietuvių,1,23,17,6,Lie,,23,0,6,0
36,Birutės,Birutės g. 4,6061804,580647,Žvėryno,36,Birutės,7,Nuo 4 iki 5 metų,4,5,1,Lietuvių,2,24,22,2,Lie,,24,0,2,0
70,Linelis,A. Mickevičiaus g. 21,6062243,580686,Žvėryno,70,Linelis,7,Nuo 4 iki 5 metų,4,5,1,Lietuvių,7,22,23,-1,Lie,,22,0,-1,0
145,Saulutė,Miglos g. 1,6063793,580537,Žvėryno,145,Saulutė,7,Nuo 4 iki 5 metų,4,5,2,Rusų,2,23,23,0,Rus,,23,0,0,0
170,Boružėlė,Latvių g. 40,6062729,580386,Žvėryno,170,Boružėlė,7,Nuo 4 iki 5 metų,4,5,1,Lietuvių,14,65,65,0,Lie,,65,0,0,0
31,Aitvaras,Pašilaičių g. 10,6066674,579323,Pašilaičių,31,Aitvaras,7,Nuo 4 iki 5 metų,4,5,1,Lietuvių,31,27,27,0,Lie,,27,0,0,0
122,Vėjelis,Gabijos g. 21,6066861,578763,Pašilaičių,122,Vėjelis,7,Nuo 4 iki 5 metų,4,5,1,Lietuvių,30,42,42,0,Lie,,42,0,0,0
122,Vėjelis,Gabijos g. 21,6066861,578763,Pašilaičių,122,Vėjelis,13,Nuo 4 iki 6 metų,4,6,1,Lietuvių,31,11,6,5,Lie,,11,0,5,0
122,Vėjelis,Gabijos g. 21,6066861,578763,Pašilaičių,122,Vėjelis,13,Nuo 4 iki 6 metų,4,6,2,Rusų,31,21,21,0,Rus,,21,0,0,0
131,Žemyna,Žemynos g. 13,6066005,579220,Pašilaičių,131,Žemyna,7,Nuo 4 iki 5 metų,4,5,1,Lietuvių,26,56,56,0,Lie,,56,0,0,0
134,Žiedas,Žemynos g. 41,6066420,579182,Pašilaičių,134,Žiedas,7,Nuo 4 iki 5 metų,4,5,1,Lietuvių,22,50,48,2,Lie,,50,0,2,0
142,Aušra,Medeinos g. 5,6066482,578753,Pašilaičių,142,Aušra,7,Nuo 4 iki 5 metų,4,5,1,Lietuvių,21,24,24,0,Lie,,24,0,0,0
163,Gabijėlė,Gabijos g. 1,6066898,579033,Pašilaičių,163,Gabijėlė,7,Nuo 4 iki 5 metų,4,5,1,Lietuvių,44,62,62,0,Lie,,62,0,0,0
378,Vilniaus Aleksandro Puškino mokykla,Gabijos g. 8,6066745,578722,Pašilaičių,378,Vilniaus Aleksandro Puškino mokykla,16,Nuo 4 iki 7 metų,4,7,2,Rusų,,43,29,14,Rus,,43,0,14,0
78,Nykštukas,Taikos g. 190,6064340,578266,Justiniškių,78,Nykštukas,7,Nuo 4 iki 5 metų,4,5,1,Lietuvių,,46,51,-5,Lie,,46,0,-5,0
88,Pasakaitė,Taikos g. 30,6065571,578966,Justiniškių,88,Pasakaitė,7,Nuo 4 iki 5 metų,4,5,1,Lietuvių,3,22,21,1,Lie,,22,0,1,0
88,Pasakaitė,Taikos g. 30,6065571,578966,Justiniškių,88,Pasakaitė,13,Nuo 4 iki 6 metų,4,6,1,Lietuvių,3,20,19,1,Lie,,20,0,1,0
90,Pelenė,Justiniškių g. 84,6065928,578486,Justiniškių,90,Pelenė,7,Nuo 4 iki 5 metų,4,5,2,Rusų,1,25,25,0,Rus,,25,0,0,0
136,Žilvinėlis,Taikos g. 130,6065108,578345,Justiniškių,136,Žilvinėlis,7,Nuo 4 iki 5 metų,4,5,1,Lietuvių,1,48,48,0,Lie,,48,0,0,0
143,Berželis,Taikos g. 187,6064814,578102,Justiniškių,143,Berželis,7,Nuo 4 iki 5 metų,4,5,2,Rusų,2,25,23,2,Rus,,25,0,2,0
152,Justinukas,Taikos g. 99,6065757,578141,Justiniškių,152,Justinukas,7,Nuo 4 iki 5 metų,4,5,1,Lietuvių,,62,62,0,Lie,,62,0,0,0
152,Justinukas,Taikos g. 99,6065757,578141,Justiniškių,152,Justinukas,13,Nuo 4 iki 6 metų,4,6,1,Lietuvių,,19,19,0,Lie,,19,0,0,0
164,Saulėgrąža,Taikos g. 31,6065577,579285,Justiniškių,164,Saulėgrąža,7,Nuo 4 iki 5 metų,4,5,1,Lietuvių,3,66,65,1,Lie,,66,0,1,0
164,Saulėgrąža,Taikos g. 31,6065577,579285,Justiniškių,164,Saulėgrąža,13,Nuo 4 iki 6 metų,4,6,1,Lietuvių,3,28,25,3,Lie,,28,0,3,0
166,Vilija,Taikos g. 15,6065426,579249,Justiniškių,166,Vilija,7,Nuo 4 iki 5 metų,4,5,4,Lenkų,,48,47,1,Len,,48,0,1,0
313,Vilniaus Taikos progimnazija,Taikos g. 157,6064995,578173,Justiniškių,313,Vilniaus Taikos progimnazija,16,Nuo 4 iki 7 metų,4,7,1,Lietuvių,,24,19,5,Lie,,24,0,5,0
58,Jurginėlis,Justiniškių g. 47,6063867,578565,Viršuliškių,58,Jurginėlis,7,Nuo 4 iki 5 metų,4,5,1,Lietuvių,1,24,22,2,Lie,,24,0,2,0
58,Jurginėlis,Justiniškių g. 47,6063867,578565,Viršuliškių,58,Jurginėlis,13,Nuo 4 iki 6 metų,4,6,1,Lietuvių,2,21,20,1,Lie,,21,0,1,0
94,Puriena,Tujų g. 1,6063771,579356,Viršuliškių,94,Puriena,7,Nuo 4 iki 5 metų,4,5,1,Lietuvių,6,48,48,0,Lie,,48,0,0,0
129,Zylutė,Justiniškių g. 45,6063900,578692,Viršuliškių,129,Zylutė,7,Nuo 4 iki 5 metų,4,5,1,Lietuvių,,34,34,0,Lie,,34,0,0,0
129,Zylutė,Justiniškių g. 45,6063900,578692,Viršuliškių,129,Zylutė,7,Nuo 4 iki 5 metų,4,5,2,Rusų,,21,22,-1,Rus,,21,0,-1,0
129,Zylutė,Justiniškių g. 45,6063900,578692,Viršuliškių,129,Zylutė,13,Nuo 4 iki 6 metų,4,6,1,Lietuvių,1,24,18,6,Lie,,24,0,6,0
129,Zylutė,Justiniškių g. 45,6063900,578692,Viršuliškių,129,Zylutė,13,Nuo 4 iki 6 metų,4,6,2,Rusų,1,15,14,1,Rus,,15,0,1,0
135,Žilvitis,Viršuliškių g. 9,6064823,579066,Viršuliškių,135,Žilvitis,7,Nuo 4 iki 5 metų,4,5,1,Lietuvių,1,46,44,2,Lie,,46,0,2,0
371,Vilniaus Jono Pauliaus II progimnazija,Rygos g. 10,6065110,578729,Viršuliškių,371,Vilniaus Jono Pauliaus II progimnazija,16,Nuo 4 iki 7 metų,4,7,4,Lenkų,,46,41,5,Len,,46,0,5,0
376,Vilniaus Viršuliškių mokykla,Viršuliškių g. 7,6064745,579010,Viršuliškių,376,Vilniaus Viršuliškių mokykla,16,Nuo 4 iki 7 metų,4,7,1,Lietuvių,1,106,80,26,Lie,,106,0,26,0
377,Gluosnis,Justiniškių g. 65,6064191,578425,Viršuliškių,377,Gluosnis,16,Nuo 4 iki 7 metų,4,7,1,Lietuvių,4,33,27,6,Lie,,33,0,6,0
42,Delfinukas,Vido Maciulevičiaus g. 32,6062079,577517,Karoliniškių,42,Delfinukas,7,Nuo 4 iki 5 metų,4,5,1,Lietuvių,17,30,29,1,Lie,,30,0,1,0
74,Medynėlis,Algimanto Petro Kavoliuko g. 5,6062825,578008,Karoliniškių,74,Medynėlis,7,Nuo 4 iki 5 metų,4,5,1,Lietuvių,24,68,66,2,Lie,,68,0,2,0
97,Raktelis,Algimanto Petro Kavoliuko g. 12,6063038,578274,Karoliniškių,97,Raktelis,7,Nuo 4 iki 5 metų,4,5,4,Lenkų,1,25,25,0,Len,,25,0,0,0
113,Strazdelis,Igno Šimulionio g. 14,6063215,579213,Karoliniškių,113,Strazdelis,7,Nuo 4 iki 5 metų,4,5,1,Lietuvių,18,66,65,1,Lie,,66,0,1,0
147,Šilelis,Sietyno g. 5,6061684,577294,Karoliniškių,147,Šilelis,7,Nuo 4 iki 5 metų,4,5,1,Lietuvių,11,24,24,0,Lie,,24,0,0,0
147,Šilelis,Sietyno g. 5,6061684,577294,Karoliniškių,147,Šilelis,7,Nuo 4 iki 5 metų,4,5,2,Rusų,11,23,23,0,Rus,,23,0,0,0
147,Šilelis,Sietyno g. 5,6061684,577294,Karoliniškių,147,Šilelis,16,Nuo 4 iki 7 metų,4,7,1,Lietuvių,11,17,13,4,Lie,,17,0,4,0
151,Žiburėlis,Laisvės pr. 46,6063037,578464,Karoliniškių,151,Žiburėlis,7,Nuo 4 iki 5 metų,4,5,1,Lietuvių,11,24,23,1,Lie,,24,0,1,0
161,Lokiukas,Igno Šimulionio g. 8,6062788,578971,Karoliniškių,161,Lokiukas,7,Nuo 4 iki 5 metų,4,5,2,Rusų,10,24,24,0,Rus,,24,0,0,0
333,Vilniaus Pranciškaus Skorinos gimnazija,Antakalnio g. 108,6065166,584743,Karoliniškių,333,Vilniaus Pranciškaus Skorinos gimnazija,16,Nuo 4 iki 7 metų,4,7,2,Rusų,,44,22,22,Rus,,44,0,22,0
336,Vilniaus Ryto progimnazija,Dariaus Gerbutavičiaus g. 9,6062641,578039,Karoliniškių,336,Vilniaus Ryto progimnazija,16,Nuo 4 iki 7 metų,4,7,1,Lietuvių,1,98,57,41,Lie,,98,0,41,0
338,Vilniaus „Spindulio“ progimnazija,Rolando Jankausko g. 17,6062339,577819,Karoliniškių,338,Vilniaus „Spindulio“ progimnazija,16,Nuo 4 iki 7 metų,4,7,1,Lietuvių,,45,33,12,Lie,,45,0,12,0
55,Giraitė,Erfurto g. 42,6060492,577795,Lazdynų,55,Giraitė,7,Nuo 4 iki 5 metų,4,5,1,Lietuvių,4,44,44,0,Lie,,44,0,0,0
68,Lazdynėlis,Lazdynų g. 36,6059832,578474,Lazdynų,68,Lazdynėlis,7,Nuo 4 iki 5 metų,4,5,1,Lietuvių,3,38,36,2,Lie,,38,0,2,0
100,Riešutėlis,Erfurto g. 21,6060722,577783,Lazdynų,100,Riešutėlis,7,Nuo 4 iki 5 metų,4,5,1,Lietuvių,3,64,64,0,Lie,,64,0,0,0
100,Riešutėlis,Erfurto g. 21,6060722,577783,Lazdynų,100,Riešutėlis,13,Nuo 4 iki 6 metų,4,6,1,Lietuvių,4,32,22,10,Lie,,32,0,10,0
101,Rytas,Architektų g. 162,6061623,578425,Lazdynų,101,Rytas,7,Nuo 4 iki 5 metų,4,5,1,Lietuvių,5,65,65,0,Lie,,65,0,0,0
132,Žemuogėlė,Architektų g. 108,6060702,577330,Lazdynų,132,Žemuogėlė,7,Nuo 4 iki 5 metų,4,5,1,Lietuvių,,21,21,0,Lie,,21,0,0,0
132,Žemuogėlė,Architektų g. 108,6060702,577330,Lazdynų,132,Žemuogėlė,13,Nuo 4 iki 6 metų,4,6,1,Lietuvių,1,18,15,3,Lie,,18,0,3,0
133,Žibutė,Architektų g. 62,6060142,578099,Lazdynų,133,Žibutė,7,Nuo 4 iki 5 metų,4,5,1,Lietuvių,2,23,22,1,Lie,,23,0,1,0
133,Žibutė,Architektų g. 62,6060142,578099,Lazdynų,133,Žibutė,13,Nuo 4 iki 6 metų,4,6,1,Lietuvių,2,23,20,3,Lie,,23,0,3,0
146,Svaja,Architektų g. 210,6061055,578652,Lazdynų,146,Svaja,7,Nuo 4 iki 5 metų,4,5,2,Rusų,8,24,24,0,Rus,,24,0,0,0
156,Obelėlė,Architektų g. 204,6061258,578692,Lazdynų,156,Obelėlė,7,Nuo 4 iki 5 metų,4,5,1,Lietuvių,3,40,39,1,Lie,,40,0,1,0
157,Spygliukas,Architektų g. 16,6060560,578449,Lazdynų,157,Spygliukas,7,Nuo 4 iki 5 metų,4,5,1,Lietuvių,4,41,39,2,Lie,,41,0,2,0
157,Spygliukas,Architektų g. 16,6060560,578449,Lazdynų,157,Spygliukas,13,Nuo 4 iki 6 metų,4,6,1,Lietuvių,4,28,24,4,Lie,,28,0,4,0
188,Lazdynų mokykla,Žėručio g. 4,6060587,578209,Lazdynų,188,Lazdynų mokykla,16,Nuo 4 iki 7 metų,4,7,2,Rusų,1,26,11,15,Rus,,26,0,15,0
188,Lazdynų mokykla,Žėručio g. 4,6060587,578209,Lazdynų,188,Lazdynų mokykla,16,Nuo 4 iki 7 metų,4,7,4,Lenkų,1,25,9,16,Len,,25,0,16,0
374,Vilniaus Sausio 13-osios mokykla,Architektų g. 166,6061530,578374,Lazdynų,374,Vilniaus Sausio 13-osios mokykla,16,Nuo 4 iki 7 metų,4,7,1,Lietuvių,2,109,67,42,Lie,,109,0,42,0
53,Gilužis,Vydūno g. 11A,6063915,576329,Pilaitės,53,Gilužis,7,Nuo 4 iki 5 metų,4,5,1,Lietuvių,37,44,44,0,Lie,,44,0,0,0
165,Pilaitukas,I. Kanto al. 7A,6063638,576320,Pilaitės,165,Pilaitukas,7,Nuo 4 iki 5 metų,4,5,1,Lietuvių,32,46,46,0,Lie,,46,0,0,0
32,Atžalėlės,Antakalnio g. 74,6064495,584600,Antakalnio,32,Atžalėlės,7,Nuo 4 iki 5 metų,4,5,1,Lietuvių,3,20,20,0,Lie,,20,0,0,0
60,Kaštonas,Antakalnio g. 108,6065166,584743,Antakalnio,60,Kaštonas,16,Nuo 4 iki 7 metų,4,7,4,Lenkų,,1,0,1,Len,,1,0,1,0
60,Kaštonas,Antakalnio g. 108,6065166,584743,Antakalnio,60,Kaštonas,16,Nuo 4 iki 7 metų,4,7,1,Lietuvių,,3,2,1,Lie,,3,0,1,0
66,Lakštingala,Lakštingalų g. 10,6066921,585208,Antakalnio,66,Lakštingala,7,Nuo 4 iki 5 metų,4,5,1,Lietuvių,1,41,43,-2,Lie,,41,0,-2,0
75,Molinukas,Keramikų g. 34,6066566,588317,Antakalnio,75,Molinukas,7,Nuo 4 iki 5 metų,4,5,1,Lietuvių,5,20,20,0,Lie,,20,0,0,0
95,Pušaitė,Bistryčios g. 3,6064071,584954,Antakalnio,95,Pušaitė,7,Nuo 4 iki 5 metų,4,5,1,Lietuvių,2,46,46,0,Lie,,46,0,0,0
111,Spindulėlis,Klinikų g. 5,6064324,584673,Antakalnio,111,Spindulėlis,13,Nuo 4 iki 6 metų,4,6,1,Lietuvių,2,24,24,0,Lie,,24,0,0,0
127,Voveraitė,Jūratės g. 4A,6063156,584800,Antakalnio,127,Voveraitė,7,Nuo 4 iki 5 metų,4,5,1,Lietuvių,2,63,63,0,Lie,,63,0,0,0
127,Voveraitė,Jūratės g. 4A,6063156,584800,Antakalnio,127,Voveraitė,13,Nuo 4 iki 6 metų,4,6,1,Lietuvių,2,23,19,4,Lie,,23,0,4,0
138,Žolynėlis,Žolyno g. 44,6064324,586286,Antakalnio,138,Žolynėlis,7,Nuo 4 iki 5 metų,4,5,1,Lietuvių,1,18,18,0,Lie,,18,0,0,0
108,Saulėtekis,Genių g. 12,6062344,591681,Naujosios Vilnios,108,Saulėtekis,7,Nuo 4 iki 5 metų,4,5,1,Lietuvių,8,46,41,5,Lie,,46,0,5,0
108,Saulėtekis,Genių g. 12,6062344,591681,Naujosios Vilnios,108,Saulėtekis,13,Nuo 4 iki 6 metų,4,6,2,Rusų,12,22,20,2,Rus,,22,0,2,0
124,Vilnelė,Pergalės g. 20,6062147,591050,Naujosios Vilnios,124,Vilnelė,7,Nuo 4 iki 5 metų,4,5,1,Lietuvių,11,63,60,3,Lie,,63,0,3,0
137,Žiogelis,J. Kolaso g. 15,6060159,587527,Naujosios Vilnios,137,Žiogelis,7,Nuo 4 iki 5 metų,4,5,1,Lietuvių,23,48,48,0,Lie,,48,0,0,0
139,Žuvėdra,Parko g. 8A,6062362,591153,Naujosios Vilnios,139,Žuvėdra,16,Nuo 4 iki 7 metų,4,7,1,Lietuvių,4,20,17,3,Lie,,20,0,3,0
171,Žaliakalnio,Pergalės g. 22,6062066,591084,Naujosios Vilnios,171,Žaliakalnio,7,Nuo 4 iki 5 metų,4,5,4,Lenkų,,45,45,0,Len,,45,0,0,0
280,Vilnios pagrindinė mokykla,Palydovo g. 29A,6063647,591077,Naujosios Vilnios,280,Vilnios pagrindinė mokykla,13,Nuo 4 iki 6 metų,4,6,1,Lietuvių,,23,12,11,Lie,,23,0,11,0
283,„Atžalyno” mokykla-darželis,Genių g. 25,6062220,591840,Naujosios Vilnios,283,„Atžalyno” mokykla-darželis,7,Nuo 4 iki 5 metų,4,5,1,Lietuvių,4,3,3,0,Lie,,3,0,0,0
370,Vilniaus Juzefo Ignacijaus Kraševskio gimnazija,Rugiagėlių g. 15,6063483,591579,Naujosios Vilnios,370,Vilniaus Juzefo Ignacijaus Kraševskio gimnazija,16,Nuo 4 iki 7 metų,4,7,4,Lenkų,,60,27,33,Len,,60,0,33,0
72,Markučiai,Pakraščio g. 15,6060712,585088,Rasų,72,Markučiai,7,Nuo 4 iki 5 metų,4,5,1,Lietuvių,1,57,57,0,Lie,,57,0,0,0
72,Markučiai,Pakraščio g. 15,6060712,585088,Rasų,72,Markučiai,13,Nuo 4 iki 6 metų,4,6,1,Lietuvių,1,19,19,0,Lie,,19,0,0,0
123,Vėtrungė,Gardino g. 8,6059622,583920,Rasų,123,Vėtrungė,7,Nuo 4 iki 5 metų,4,5,1,Lietuvių,4,69,66,3,Lie,,69,0,3,0
56,Gudrutis,Trakų g. 12,6061176,582562,Senamiesčio,56,Gudrutis,7,Nuo 4 iki 5 metų,4,5,1,Lietuvių,6,23,22,1,Lie,,23,0,1,0
61,Krivūlė,Lydos g. 5,6060976,582608,Senamiesčio,61,Krivūlė,7,Nuo 4 iki 5 metų,4,5,1,Lietuvių,10,40,40,0,Lie,,40,0,0,0
98,Rasa,M. Daukšos g. 15,6060531,583570,Senamiesčio,98,Rasa,7,Nuo 4 iki 5 metų,4,5,1,Lietuvių,1,39,39,0,Lie,,39,0,0,0
116,Šypsena,Povilo Višinskio g. 23,6060511,584155,Senamiesčio,116,Šypsena,7,Nuo 4 iki 5 metų,4,5,4,Lenkų,2,20,20,0,Len,,20,0,0,0
118,Užupiukas,Filaretų g. 19,6061661,584234,Senamiesčio,118,Užupiukas,7,Nuo 4 iki 5 metų,4,5,1,Lietuvių,7,69,64,5,Lie,,69,0,5,0
155,Gėlynas,Gėlių g. 9A,6060442,582724,Senamiesčio,155,Gėlynas,7,Nuo 4 iki 5 metų,4,5,1,Lietuvių,7,22,22,0,Lie,,22,0,0,0
34,Beržynėlis,Beržyno g. 7A,6061242,580943,Naujamiesčio,34,Beržynėlis,7,Nuo 4 iki 5 metų,4,5,1,Lietuvių,3,24,24,0,Lie,,24,0,0,0
44,Drevinukas,K. Donelaičio g. 12,6061130,580761,Naujamiesčio,44,Drevinukas,7,Nuo 4 iki 5 metų,4,5,1,Lietuvių,,46,42,4,Lie,,46,0,4,0
50,Geniukų kalvė,Muitinės g. 30,6060904,581368,Naujamiesčio,50,Geniukų kalvė,7,Nuo 4 iki 5 metų,4,5,1,Lietuvių,1,24,24,0,Lie,,24,0,0,0
64,Kurpaitė,Birželio 23-iosios g. 6,6060317,581350,Naujamiesčio,64,Kurpaitė,7,Nuo 4 iki 5 metų,4,5,2,Rusų,3,22,22,0,Rus,,22,0,0,0
65,Kūlverstukas,Suvalkų g. 6,6061494,581645,Naujamiesčio,65,Kūlverstukas,7,Nuo 4 iki 5 metų,4,5,2,Rusų,3,23,21,2,Rus,,23,0,2,0
73,Mažylis,A. Vivulskio g. 8A,6060972,581880,Naujamiesčio,73,Mažylis,7,Nuo 4 iki 5 metų,4,5,1,Lietuvių,4,24,22,2,Lie,,24,0,2,0
81,Pagrandukas,Mindaugo g. 15A,6060779,582121,Naujamiesčio,81,Pagrandukas,7,Nuo 4 iki 5 metų,4,5,1,Lietuvių,3,20,18,2,Lie,,20,0,2,0
104,Sadutė,Z. Sierakausko g. 28,6061537,581487,Naujamiesčio,104,Sadutė,7,Nuo 4 iki 5 metų,4,5,1,Lietuvių,2,27,25,2,Lie,,27,0,2,0
107,Salvija,J. Jasinskio g. 17,6062109,581253,Naujamiesčio,107,Salvija,16,Nuo 4 iki 7 metų,4,7,8,Hebrajų,,29,24,5,Heb,,29,0,5,0
117,Šnekutis,Vytenio g. 41,6060541,581507,Naujamiesčio,117,Šnekutis,7,Nuo 4 iki 5 metų,4,5,1,Lietuvių,,24,24,0,Lie,,24,0,0,0
160,Dainorėliai,Ankštoji g. 11,6062282,581589,Naujamiesčio,160,Dainorėliai,7,Nuo 4 iki 5 metų,4,5,1,Lietuvių,1,22,22,0,Lie,,22,0,0,0
160,Dainorėliai,Ankštoji g. 11,6062282,581589,Naujamiesčio,160,Dainorėliai,16,Nuo 4 iki 7 metų,4,7,1,Lietuvių,2,30,26,4,Lie,,30,0,4,0
314,Vilniaus Karaliaus Mindaugo pagrindinė mokykla,Mindaugo g. 9,6060990,582092,Naujamiesčio,314,Vilniaus Karaliaus Mindaugo pagrindinė mokykla,16,Nuo 4 iki 7 metų,4,7,1,Lietuvių,,75,51,24,Lie,,75,0,24,0
33,Aušrelė,Gerosios Vilties g. 28,6060144,580536,Vilkpėdės,33,Aušrelė,7,Nuo 4 iki 5 metų,4,5,1,Lietuvių,,50,38,12,Lie,,50,0,12,0
33,Aušrelė,Gerosios Vilties g. 28,6060144,580536,Vilkpėdės,33,Aušrelė,13,Nuo 4 iki 6 metų,4,6,1,Lietuvių,,27,20,7,Lie,,27,0,7,0
109,Skroblinukas,Skroblų g. 13,6060044,580835,Vilkpėdės,109,Skroblinukas,7,Nuo 4 iki 5 metų,4,5,1,Lietuvių,1,41,41,0,Lie,,41,0,0,0
126,Viltenė,Gerosios Vilties g. 7A,6059971,580171,Vilkpėdės,126,Viltenė,7,Nuo 4 iki 5 metų,4,5,1,Lietuvių,,47,47,0,Lie,,47,0,0,0
149,Vaduvos,Vaduvos g. 14A,6056378,577898,Vilkpėdės,149,Vaduvos,7,Nuo 4 iki 5 metų,4,5,1,Lietuvių,4,20,19,1,Lie,,20,0,1,0
150,Vilkpėdės,Gerosios Vilties g. 15,6059880,580271,Vilkpėdės,150,Vilkpėdės,7,Nuo 4 iki 5 metų,4,5,1,Lietuvių,1,24,21,3,Lie,,24,0,3,0
154,Bangelė,Žemaitės g. 3,6060388,580757,Vilkpėdės,154,Bangelė,13,Nuo 4 iki 6 metų,4,6,2,Rusų,1,23,20,3,Rus,,23,0,3,0
154,Bangelė,Žemaitės g. 3,6060388,580757,Vilkpėdės,154,Bangelė,16,Nuo 4 iki 7 metų,4,7,4,Lenkų,,28,24,4,Len,,28,0,4,0
41,Daigelis,Dariaus ir Girėno g. 14,6059212,582247,Naujininkų,41,Daigelis,16,Nuo 4 iki 7 metų,4,7,2,Rusų,3,20,20,0,Rus,,20,0,0,0
46,Du gaideliai,Pelesos g. 15,6059555,582659,Naujininkų,46,Du gaideliai,7,Nuo 4 iki 5 metų,4,5,1,Lietuvių,5,19,19,0,Lie,,19,0,0,0
52,Gervelė,Dzūkų g. 32,6059430,582938,Naujininkų,52,Gervelė,7,Nuo 4 iki 5 metų,4,5,1,Lietuvių,2,21,20,1,Lie,,21,0,1,0
69,Liepsnelė,Kapsų g. 7,6059010,582319,Naujininkų,69,Liepsnelė,7,Nuo 4 iki 5 metų,4,5,2,Rusų,2,23,23,0,Rus,,23,0,0,0
69,Liepsnelė,Kapsų g. 7,6059010,582319,Naujininkų,69,Liepsnelė,16,Nuo 4 iki 7 metų,4,7,1,Lietuvių,1,26,23,3,Lie,,26,0,3,0
80,Pabiručiai,Brolių g. 18,6059283,581775,Naujininkų,80,Pabiručiai,7,Nuo 4 iki 5 metų,4,5,1,Lietuvių,3,47,46,1,Lie,,47,0,1,0
106,Salininkų,Kalviškių g. 1,6052946,581325,Naujininkų,106,Salininkų,7,Nuo 4 iki 5 metų,4,5,1,Lietuvių,14,23,23,0,Lie,,23,0,0,0
130,Želmenėliai,Šaltkalvių g. 30,6058911,581955,Naujininkų,130,Želmenėliai,7,Nuo 4 iki 5 metų,4,5,1,Lietuvių,2,43,42,1,Lie,,43,0,1,0
130,Želmenėliai,Šaltkalvių g. 30,6058911,581955,Naujininkų,130,Želmenėliai,13,Nuo 4 iki 6 metų,4,6,1,Lietuvių,2,22,19,3,Lie,,22,0,3,0
311,Vilniaus Naujininkų mokykla,Šaltkalvių g. 32,6058943,581862,Naujininkų,311,Vilniaus Naujininkų mokykla,16,Nuo 4 iki 7 metų,4,7,1,Lietuvių,2,34,29,5,Lie,,34,0,5,0
383,Vilniaus Saulėtekio mokykla-daugiafunkcinis centras,Kaminkelio g. 10,6058856,582305,Naujininkų,383,Vilniaus Saulėtekio mokykla-daugiafunkcinis centras,16,Nuo 4 iki 7 metų,4,7,2,Rusų,3,23,20,3,Rus,,23,0,3,0
83,Panerių,Juodšilių g. 10,6055221,576151,Panerių,83,Panerių,16,Nuo 4 iki 7 metų,4,7,1,Lietuvių,1,22,19,3,Lie,,22,0,3,0
128,Trakų Vokė,Eduardo Andrė g. 6,6055241,571717,Panerių,128,Trakų Vokė,7,Nuo 4 iki 5 metų,4,5,1,Lietuvių,6,21,21,0,Lie,,21,0,0,0
335,Vilniaus Trakų Vokės gimnazija,Trampolio g. 5,6055129,571743,Panerių,335,Vilniaus Trakų Vokės gimnazija,16,Nuo 4 iki 7 metų,4,7,1,Lietuvių,,40,24,16,Lie,,40,0,16,0
71,Lokiuko giraitė,Kovo 11-osios g. 54,6059688,571108,Grigiškių,71,Lokiuko giraitė,7,Nuo 4 iki 5 metų,4,5,1,Lietuvių,2,47,45,2,Lie,,47,0,2,0
99,Rugelis,Kovo 11-osios g. 29A,6059755,570487,Grigiškių,99,Rugelis,7,Nuo 4 iki 5 metų,4,5,1,Lietuvių,2,43,43,0,Lie,,43,0,0,0
99,Rugelis,Kovo 11-osios g. 29A,6059755,570487,Grigiškių,99,Rugelis,13,Nuo 4 iki 6 metų,4,6,2,Rusų,,23,23,0,Rus,,23,0,0,0
144,Pelėdžiukas,Lentvario g. 1,6060250,569710,Grigiškių,144,Pelėdžiukas,7,Nuo 4 iki 5 metų,4,5,1,Lietuvių,4,45,45,0,Lie,,45,0,0,0
375,Vilniaus savivaldybės Grigiškių gimnazija,Kovo 11-osios g. 21,6059984,570222,Grigiškių,375,Vilniaus savivaldybės Grigiškių gimnazija,16,Nuo 4 iki 7 metų,4,7,2,Rusų,1,69,48,21,Rus,,69,0,21,0
375,Vilniaus savivaldybės Grigiškių gimnazija,Kovo 11-osios g. 21,6059984,570222,Grigiškių,375,Vilniaus savivaldybės Grigiškių gimnazija,16,Nuo 4 iki 7 metų,4,7,4,Lenkų,1,30,9,21,Len,,30,0,21,0
40,Čiauškutis,Sausio 13-osios g. 6,6062138,578557,Visos seniūnijos,40,Čiauškutis,7,Nuo 4 iki 5 metų,4,5,1,Lietuvių,,49,47,2,Lie,,49,0,2,0
92,Prie pasakų parko,Loretos Asanavičiūtės g. 7,6061370,577417,Visos seniūnijos,92,Prie pasakų parko,13,Nuo 4 iki 6 metų,4,6,2,Rusų,,18,16,2,Rus,,18,0,2,0
92,Prie pasakų parko,Loretos Asanavičiūtės g. 7,6061370,577417,Visos seniūnijos,92,Prie pasakų parko,16,Nuo 4 iki 7 metų,4,7,2,Rusų,,13,9,4,Rus,,13,0,4,0
189,VĮ Mažasis Trinapolis mok. 160 Eur,Trinapolio g. 11,6066065,583013,Visos seniūnijos,189,VĮ Mažasis Trinapolis mok. 160 Eur,7,Nuo 4 iki 5 metų,4,5,1,Lietuvių,7,9,14,-5,Lie,,9,0,-5,0
189,VĮ Mažasis Trinapolis mok. 160 Eur,Trinapolio g. 11,6066065,583013,Visos seniūnijos,189,VĮ Mažasis Trinapolis mok. 160 Eur,13,Nuo 4 iki 6 metų,4,6,1,Lietuvių,7,16,17,-1,Lie,,16,0,-1,0
54,Gintarėlis,Didlaukio g. 35,6066821,581859,Verkių,54,Gintarėlis,8,Nuo 5 iki 6 metų,5,6,1,Lietuvių,35,69,68,1,Lie,,69,0,1,0
115,Šermukšnėlė,Didlaukio g. 66,6066405,581924,Verkių,115,Šermukšnėlė,8,Nuo 5 iki 6 metų,5,6,1,Lietuvių,27,57,56,1,Lie,,57,0,1,0
115,Šermukšnėlė,Didlaukio g. 66,6066405,581924,Verkių,115,Šermukšnėlė,11,Nuo 5 iki 7 metų,5,7,1,Lietuvių,28,24,17,7,Lie,,24,0,7,0
115,Šermukšnėlė,Didlaukio g. 66,6066405,581924,Verkių,115,Šermukšnėlė,11,Nuo 5 iki 7 metų,5,7,2,Rusų,28,16,16,0,Rus,,16,0,0,0
273,Santariškių,Santariškių g. 27,6070076,582528,Verkių,273,Santariškių,8,Nuo 5 iki 6 metų,5,6,1,Lietuvių,72,87,87,0,Lie,,87,0,0,0
86,Pasaka,Žirmūnų g. 110,6066164,583842,Žirmūnų,86,Pasaka,8,Nuo 5 iki 6 metų,5,6,1,Lietuvių,10,41,41,0,Lie,,41,0,0,0
102,Ramunėlė,Žirmūnų g. 10,6063400,583684,Žirmūnų,102,Ramunėlė,8,Nuo 5 iki 6 metų,5,6,1,Lietuvių,,43,43,0,Lie,,43,0,0,0
102,Ramunėlė,Žirmūnų g. 10,6063400,583684,Žirmūnų,102,Ramunėlė,11,Nuo 5 iki 7 metų,5,7,2,Rusų,3,25,25,0,Rus,,25,0,0,0
103,Rūta,Žirmūnų g. 50,6063864,583954,Žirmūnų,103,Rūta,8,Nuo 5 iki 6 metų,5,6,1,Lietuvių,,39,39,0,Lie,,39,0,0,0
110,Smalsučiai,Minties g. 40,6063682,583483,Žirmūnų,110,Smalsučiai,8,Nuo 5 iki 6 metų,5,6,1,Lietuvių,4,17,17,0,Lie,,17,0,0,0
112,Spragtukas,Žirmūnų g. 108,6066278,583825,Žirmūnų,112,Spragtukas,8,Nuo 5 iki 6 metų,5,6,1,Lietuvių,2,23,23,0,Lie,,23,0,0,0
112,Spragtukas,Žirmūnų g. 108,6066278,583825,Žirmūnų,112,Spragtukas,8,Nuo 5 iki 6 metų,5,6,2,Rusų,2,22,22,0,Rus,,22,0,0,0
119,Vaidilutė,Rinktinės g. 29,6063132,583062,Žirmūnų,119,Vaidilutė,8,Nuo 5 iki 6 metų,5,6,1,Lietuvių,,25,25,0,Lie,,25,0,0,0
119,Vaidilutė,Rinktinės g. 29,6063132,583062,Žirmūnų,119,Vaidilutė,11,Nuo 5 iki 7 metų,5,7,1,Lietuvių,2,20,20,0,Lie,,20,0,0,0
141,Žirniukas,Verkių g. 17,6064137,582995,Žirmūnų,141,Žirniukas,8,Nuo 5 iki 6 metų,5,6,1,Lietuvių,9,26,20,6,Lie,,26,0,6,0
148,Vaivorykštė,Tuskulėnų g. 42,6063314,583236,Žirmūnų,148,Vaivorykštė,11,Nuo 5 iki 7 metų,5,7,2,Rusų,4,56,54,2,Rus,,56,0,2,0
158,Vieversys,Žirmūnų g. 89,6065626,584093,Žirmūnų,158,Vieversys,8,Nuo 5 iki 6 metų,5,6,1,Lietuvių,1,72,69,3,Lie,,72,0,3,0
159,Žirmūnėliai,Žirmūnų g. 13,6064686,584179,Žirmūnų,159,Žirmūnėliai,8,Nuo 5 iki 6 metų,5,6,1,Lietuvių,10,45,44,1,Lie,,45,0,1,0
159,Žirmūnėliai,Žirmūnų g. 13,6064686,584179,Žirmūnų,159,Žirmūnėliai,11,Nuo 5 iki 7 metų,5,7,1,Lietuvių,10,6,2,4,Lie,,6,0,4,0
327,Ąžuolas,Žirmūnų g. 32,6063664,583795,Žirmūnų,327,Ąžuolas,8,Nuo 5 iki 6 metų,5,6,1,Lietuvių,4,22,22,0,Lie,,22,0,0,0
45,Drugelis,Rinktinės g. 28A,6062920,582954,Šnipiškių,45,Drugelis,8,Nuo 5 iki 6 metų,5,6,1,Lietuvių,5,26,21,5,Lie,,26,0,5,0
45,Drugelis,Rinktinės g. 28A,6062920,582954,Šnipiškių,45,Drugelis,11,Nuo 5 iki 7 metų,5,7,1,Lietuvių,5,2,1,1,Lie,,2,0,1,0
91,Pipiras,Krokuvos g. 6A,6062992,582810,Šnipiškių,91,Pipiras,8,Nuo 5 iki 6 metų,5,6,1,Lietuvių,3,75,75,0,Lie,,75,0,0,0
91,Pipiras,Krokuvos g. 6A,6062992,582810,Šnipiškių,91,Pipiras,11,Nuo 5 iki 7 metų,5,7,1,Lietuvių,3,6,3,3,Lie,,6,0,3,0
93,Pumpurėlis,Kalvarijų g. 186,6064711,582594,Šnipiškių,93,Pumpurėlis,8,Nuo 5 iki 6 metų,5,6,1,Lietuvių,13,41,41,0,Lie,,41,0,0,0
93,Pumpurėlis,Kalvarijų g. 186,6064711,582594,Šnipiškių,93,Pumpurėlis,11,Nuo 5 iki 7 metų,5,7,1,Lietuvių,13,51,43,8,Lie,,51,0,8,0
140,Žvangutis,Rinktinės g. 38A,6063137,582826,Šnipiškių,140,Žvangutis,8,Nuo 5 iki 6 metų,5,6,1,Lietuvių,3,21,21,0,Lie,,21,0,0,0
140,Žvangutis,Rinktinės g. 38A,6063137,582826,Šnipiškių,140,Žvangutis,11,Nuo 5 iki 7 metų,5,7,1,Lietuvių,3,24,20,4,Lie,,24,0,4,0
169,Švelnukas,Žalgirio g. 115,6063870,582480,Šnipiškių,169,Švelnukas,8,Nuo 5 iki 6 metų,5,6,1,Lietuvių,5,22,22,0,Lie,,22,0,0,0
49,Gandriukas,Fabijoniškių g. 7,6065778,580283,Fabijoniškių,49,Gandriukas,8,Nuo 5 iki 6 metų,5,6,1,Lietuvių,18,49,49,0,Lie,,49,0,0,0
57,Jovarėlis,S. Stanevičiaus g. 21,6065899,580839,Fabijoniškių,57,Jovarėlis,8,Nuo 5 iki 6 metų,5,6,1,Lietuvių,13,99,96,3,Lie,,99,0,3,0
59,Karusėlė,Gedvydžių g. 25,6067384,579862,Fabijoniškių,59,Karusėlė,8,Nuo 5 iki 6 metų,5,6,2,Rusų,,22,22,0,Rus,,22,0,0,0
59,Karusėlė,Gedvydžių g. 25,6067384,579862,Fabijoniškių,59,Karusėlė,11,Nuo 5 iki 7 metų,5,7,1,Lietuvių,2,18,14,4,Lie,,18,0,4,0
105,Sakalėlis,S. Stanevičiaus g. 86,6066416,580734,Fabijoniškių,105,Sakalėlis,8,Nuo 5 iki 6 metų,5,6,1,Lietuvių,12,24,24,0,Lie,,24,0,0,0
120,Vandenis,P. Žadeikos g. 14A,6067055,579871,Fabijoniškių,120,Vandenis,8,Nuo 5 iki 6 metų,5,6,1,Lietuvių,22,64,64,0,Lie,,64,0,0,0
125,Vėrinėlis,S. Stanevičiaus g. 68,6066291,580732,Fabijoniškių,125,Vėrinėlis,11,Nuo 5 iki 7 metų,5,7,1,Lietuvių,9,20,20,0,Lie,,20,0,0,0
125,Vėrinėlis,S. Stanevičiaus g. 68,6066291,580732,Fabijoniškių,125,Vėrinėlis,11,Nuo 5 iki 7 metų,5,7,4,Lenkų,9,19,19,0,Len,,19,0,0,0
37,Bitutė,Paberžės g. 20,6065254,580866,Šeškinės,37,Bitutė,8,Nuo 5 iki 6 metų,5,6,1,Lietuvių,,61,60,1,Lie,,61,0,1,0
51,Gelvonėlis,Gelvonų g. 1,6065015,581076,Šeškinės,51,Gelvonėlis,8,Nuo 5 iki 6 metų,5,6,1,Lietuvių,4,24,22,2,Lie,,24,0,2,0
51,Gelvonėlis,Gelvonų g. 1,6065015,581076,Šeškinės,51,Gelvonėlis,8,Nuo 5 iki 6 metų,5,6,2,Rusų,4,21,21,0,Rus,,21,0,0,0
62,Kodėlčiukas,Laisvės pr. 59,6065259,579457,Šeškinės,62,Kodėlčiukas,8,Nuo 5 iki 6 metų,5,6,1,Lietuvių,2,40,41,-1,Lie,,40,0,-1,0
62,Kodėlčiukas,Laisvės pr. 59,6065259,579457,Šeškinės,62,Kodėlčiukas,11,Nuo 5 iki 7 metų,5,7,1,Lietuvių,4,16,16,0,Lie,,16,0,0,0
79,Ozas,Gelvonų g. 24,6064973,580945,Šeškinės,79,Ozas,8,Nuo 5 iki 6 metų,5,6,1,Lietuvių,3,63,63,0,Lie,,63,0,0,0
84,Papartis,Čiobiškio g. 17,6065285,579915,Šeškinės,84,Papartis,8,Nuo 5 iki 6 metų,5,6,1,Lietuvių,,53,53,0,Lie,,53,0,0,0
89,Pelėda,Musninkų g. 10,6065012,579870,Šeškinės,89,Pelėda,8,Nuo 5 iki 6 metų,5,6,1,Lietuvių,4,47,47,0,Lie,,47,0,0,0
114,Sveikuolis,Dūkštų g. 14,6064690,580111,Šeškinės,114,Sveikuolis,8,Nuo 5 iki 6 metų,5,6,2,Rusų,,45,44,1,Rus,,45,0,1,0
121,Varpelis,Ukmergės g. 204,6064729,580302,Šeškinės,121,Varpelis,8,Nuo 5 iki 6 metų,5,6,1,Lietuvių,1,35,35,0,Lie,,35,0,0,0
36,Birutės,Birutės g. 4,6061804,580647,Žvėryno,36,Birutės,8,Nuo 5 iki 6 metų,5,6,1,Lietuvių,7,25,24,1,Lie,,25,0,1,0
47,Eglutė,Miglos g. 3,6063700,580436,Žvėryno,47,Eglutė,8,Nuo 5 iki 6 metų,5,6,1,Lietuvių,5,50,50,0,Lie,,50,0,0,0
70,Linelis,A. Mickevičiaus g. 21,6062243,580686,Žvėryno,70,Linelis,11,Nuo 5 iki 7 metų,5,7,1,Lietuvių,12,20,20,0,Lie,,20,0,0,0
145,Saulutė,Miglos g. 1,6063793,580537,Žvėryno,145,Saulutė,8,Nuo 5 iki 6 metų,5,6,2,Rusų,2,21,20,1,Rus,,21,0,1,0
145,Saulutė,Miglos g. 1,6063793,580537,Žvėryno,145,Saulutė,11,Nuo 5 iki 7 metų,5,7,2,Rusų,6,22,22,0,Rus,,22,0,0,0
170,Boružėlė,Latvių g. 40,6062729,580386,Žvėryno,170,Boružėlė,8,Nuo 5 iki 6 metų,5,6,1,Lietuvių,12,50,50,0,Lie,,50,0,0,0
31,Aitvaras,Pašilaičių g. 10,6066674,579323,Pašilaičių,31,Aitvaras,8,Nuo 5 iki 6 metų,5,6,1,Lietuvių,2,43,42,1,Lie,,43,0,1,0
122,Vėjelis,Gabijos g. 21,6066861,578763,Pašilaičių,122,Vėjelis,8,Nuo 5 iki 6 metų,5,6,1,Lietuvių,1,22,22,0,Lie,,22,0,0,0
122,Vėjelis,Gabijos g. 21,6066861,578763,Pašilaičių,122,Vėjelis,8,Nuo 5 iki 6 metų,5,6,4,Lenkų,1,20,20,0,Len,,20,0,0,0
122,Vėjelis,Gabijos g. 21,6066861,578763,Pašilaičių,122,Vėjelis,11,Nuo 5 iki 7 metų,5,7,1,Lietuvių,7,21,21,0,Lie,,21,0,0,0
122,Vėjelis,Gabijos g. 21,6066861,578763,Pašilaičių,122,Vėjelis,11,Nuo 5 iki 7 metų,5,7,2,Rusų,7,21,21,0,Rus,,21,0,0,0
131,Žemyna,Žemynos g. 13,6066005,579220,Pašilaičių,131,Žemyna,8,Nuo 5 iki 6 metų,5,6,1,Lietuvių,3,73,73,0,Lie,,73,0,0,0
134,Žiedas,Žemynos g. 41,6066420,579182,Pašilaičių,134,Žiedas,8,Nuo 5 iki 6 metų,5,6,1,Lietuvių,,48,48,0,Lie,,48,0,0,0
134,Žiedas,Žemynos g. 41,6066420,579182,Pašilaičių,134,Žiedas,11,Nuo 5 iki 7 metų,5,7,2,Rusų,1,18,18,0,Rus,,18,0,0,0
142,Aušra,Medeinos g. 5,6066482,578753,Pašilaičių,142,Aušra,8,Nuo 5 iki 6 metų,5,6,1,Lietuvių,6,23,23,0,Lie,,23,0,0,0
163,Gabijėlė,Gabijos g. 1,6066898,579033,Pašilaičių,163,Gabijėlė,8,Nuo 5 iki 6 metų,5,6,1,Lietuvių,3,80,79,1,Lie,,80,0,1,0
78,Nykštukas,Taikos g. 190,6064340,578266,Justiniškių,78,Nykštukas,8,Nuo 5 iki 6 metų,5,6,1,Lietuvių,,42,45,-3,Lie,,42,0,-3,0
88,Pasakaitė,Taikos g. 30,6065571,578966,Justiniškių,88,Pasakaitė,8,Nuo 5 iki 6 metų,5,6,1,Lietuvių,,19,19,0,Lie,,19,0,0,0
90,Pelenė,Justiniškių g. 84,6065928,578486,Justiniškių,90,Pelenė,8,Nuo 5 iki 6 metų,5,6,2,Rusų,,24,22,2,Rus,,24,0,2,0
90,Pelenė,Justiniškių g. 84,6065928,578486,Justiniškių,90,Pelenė,11,Nuo 5 iki 7 metų,5,7,2,Rusų,1,20,18,2,Rus,,20,0,2,0
90,Pelenė,Justiniškių g. 84,6065928,578486,Justiniškių,90,Pelenė,11,Nuo 5 iki 7 metų,5,7,1,Lietuvių,1,40,39,1,Lie,,40,0,1,0
136,Žilvinėlis,Taikos g. 130,6065108,578345,Justiniškių,136,Žilvinėlis,8,Nuo 5 iki 6 metų,5,6,1,Lietuvių,1,47,47,0,Lie,,47,0,0,0
143,Berželis,Taikos g. 187,6064814,578102,Justiniškių,143,Berželis,8,Nuo 5 iki 6 metų,5,6,2,Rusų,,19,19,0,Rus,,19,0,0,0
143,Berželis,Taikos g. 187,6064814,578102,Justiniškių,143,Berželis,11,Nuo 5 iki 7 metų,5,7,2,Rusų,,28,25,3,Rus,,28,0,3,0
152,Justinukas,Taikos g. 99,6065757,578141,Justiniškių,152,Justinukas,8,Nuo 5 iki 6 metų,5,6,1,Lietuvių,,48,48,0,Lie,,48,0,0,0
164,Saulėgrąža,Taikos g. 31,6065577,579285,Justiniškių,164,Saulėgrąža,8,Nuo 5 iki 6 metų,5,6,1,Lietuvių,,40,40,0,Lie,,40,0,0,0
166,Vilija,Taikos g. 15,6065426,579249,Justiniškių,166,Vilija,8,Nuo 5 iki 6 metų,5,6,4,Lenkų,1,61,59,2,Len,,61,0,2,0
58,Jurginėlis,Justiniškių g. 47,6063867,578565,Viršuliškių,58,Jurginėlis,8,Nuo 5 iki 6 metų,5,6,1,Lietuvių,1,41,41,0,Lie,,41,0,0,0
94,Puriena,Tujų g. 1,6063771,579356,Viršuliškių,94,Puriena,8,Nuo 5 iki 6 metų,5,6,1,Lietuvių,1,43,43,0,Lie,,43,0,0,0
135,Žilvitis,Viršuliškių g. 9,6064823,579066,Viršuliškių,135,Žilvitis,8,Nuo 5 iki 6 metų,5,6,1,Lietuvių,1,45,45,0,Lie,,45,0,0,0
42,Delfinukas,Vido Maciulevičiaus g. 32,6062079,577517,Karoliniškių,42,Delfinukas,8,Nuo 5 iki 6 metų,5,6,1,Lietuvių,3,51,51,0,Lie,,51,0,0,0
74,Medynėlis,Algimanto Petro Kavoliuko g. 5,6062825,578008,Karoliniškių,74,Medynėlis,8,Nuo 5 iki 6 metų,5,6,1,Lietuvių,,78,78,0,Lie,,78,0,0,0
97,Raktelis,Algimanto Petro Kavoliuko g. 12,6063038,578274,Karoliniškių,97,Raktelis,8,Nuo 5 iki 6 metų,5,6,4,Lenkų,3,23,23,0,Len,,23,0,0,0
97,Raktelis,Algimanto Petro Kavoliuko g. 12,6063038,578274,Karoliniškių,97,Raktelis,11,Nuo 5 iki 7 metų,5,7,2,Rusų,,17,17,0,Rus,,17,0,0,0
113,Strazdelis,Igno Šimulionio g. 14,6063215,579213,Karoliniškių,113,Strazdelis,8,Nuo 5 iki 6 metų,5,6,1,Lietuvių,,45,42,3,Lie,,45,0,3,0
147,Šilelis,Sietyno g. 5,6061684,577294,Karoliniškių,147,Šilelis,8,Nuo 5 iki 6 metų,5,6,1,Lietuvių,,20,20,0,Lie,,20,0,0,0
147,Šilelis,Sietyno g. 5,6061684,577294,Karoliniškių,147,Šilelis,8,Nuo 5 iki 6 metų,5,6,2,Rusų,,17,17,0,Rus,,17,0,0,0
147,Šilelis,Sietyno g. 5,6061684,577294,Karoliniškių,147,Šilelis,11,Nuo 5 iki 7 metų,5,7,2,Rusų,,2,2,0,Rus,,2,0,0,0
151,Žiburėlis,Laisvės pr. 46,6063037,578464,Karoliniškių,151,Žiburėlis,8,Nuo 5 iki 6 metų,5,6,1,Lietuvių,2,24,24,0,Lie,,24,0,0,0
161,Lokiukas,Igno Šimulionio g. 8,6062788,578971,Karoliniškių,161,Lokiukas,8,Nuo 5 iki 6 metų,5,6,2,Rusų,10,25,25,0,Rus,,25,0,0,0
161,Lokiukas,Igno Šimulionio g. 8,6062788,578971,Karoliniškių,161,Lokiukas,11,Nuo 5 iki 7 metų,5,7,2,Rusų,10,30,25,5,Rus,,30,0,5,0
55,Giraitė,Erfurto g. 42,6060492,577795,Lazdynų,55,Giraitė,8,Nuo 5 iki 6 metų,5,6,1,Lietuvių,1,62,62,0,Lie,,62,0,0,0
68,Lazdynėlis,Lazdynų g. 36,6059832,578474,Lazdynų,68,Lazdynėlis,8,Nuo 5 iki 6 metų,5,6,1,Lietuvių,14,60,60,0,Lie,,60,0,0,0
68,Lazdynėlis,Lazdynų g. 36,6059832,578474,Lazdynų,68,Lazdynėlis,11,Nuo 5 iki 7 metų,5,7,1,Lietuvių,14,26,25,1,Lie,,26,0,1,0
82,Pakalnutė,Architektų g. 44,6060245,578504,Lazdynų,82,Pakalnutė,8,Nuo 5 iki 6 metų,5,6,1,Lietuvių,1,38,36,2,Lie,,38,0,2,0
100,Riešutėlis,Erfurto g. 21,6060722,577783,Lazdynų,100,Riešutėlis,8,Nuo 5 iki 6 metų,5,6,1,Lietuvių,1,38,38,0,Lie,,38,0,0,0
101,Rytas,Architektų g. 162,6061623,578425,Lazdynų,101,Rytas,8,Nuo 5 iki 6 metų,5,6,1,Lietuvių,3,75,75,0,Lie,,75,0,0,0
101,Rytas,Architektų g. 162,6061623,578425,Lazdynų,101,Rytas,11,Nuo 5 iki 7 metų,5,7,1,Lietuvių,5,7,3,4,Lie,,7,0,4,0
132,Žemuogėlė,Architektų g. 108,6060702,577330,Lazdynų,132,Žemuogėlė,8,Nuo 5 iki 6 metų,5,6,1,Lietuvių,1,18,18,0,Lie,,18,0,0,0
132,Žemuogėlė,Architektų g. 108,6060702,577330,Lazdynų,132,Žemuogėlė,11,Nuo 5 iki 7 metų,5,7,1,Lietuvių,3,15,13,2,Lie,,15,0,2,0
132,Žemuogėlė,Architektų g. 108,6060702,577330,Lazdynų,132,Žemuogėlė,11,Nuo 5 iki 7 metų,5,7,2,Rusų,3,20,19,1,Rus,,20,0,1,0
146,Svaja,Architektų g. 210,6061055,578652,Lazdynų,146,Svaja,8,Nuo 5 iki 6 metų,5,6,2,Rusų,14,20,20,0,Rus,,20,0,0,0
146,Svaja,Architektų g. 210,6061055,578652,Lazdynų,146,Svaja,11,Nuo 5 iki 7 metų,5,7,2,Rusų,15,44,37,7,Rus,,44,0,7,0
156,Obelėlė,Architektų g. 204,6061258,578692,Lazdynų,156,Obelėlė,8,Nuo 5 iki 6 metų,5,6,1,Lietuvių,,39,39,0,Lie,,39,0,0,0
157,Spygliukas,Architektų g. 16,6060560,578449,Lazdynų,157,Spygliukas,8,Nuo 5 iki 6 metų,5,6,1,Lietuvių,,21,21,0,Lie,,21,0,0,0
157,Spygliukas,Architektų g. 16,6060560,578449,Lazdynų,157,Spygliukas,11,Nuo 5 iki 7 metų,5,7,1,Lietuvių,,16,16,0,Lie,,16,0,0,0
53,Gilužis,Vydūno g. 11A,6063915,576329,Pilaitės,53,Gilužis,8,Nuo 5 iki 6 metų,5,6,1,Lietuvių,31,65,65,0,Lie,,65,0,0,0
165,Pilaitukas,I. Kanto al. 7A,6063638,576320,Pilaitės,165,Pilaitukas,8,Nuo 5 iki 6 metų,5,6,1,Lietuvių,30,45,45,0,Lie,,45,0,0,0
32,Atžalėlės,Antakalnio g. 74,6064495,584600,Antakalnio,32,Atžalėlės,8,Nuo 5 iki 6 metų,5,6,1,Lietuvių,2,27,27,0,Lie,,27,0,0,0
60,Kaštonas,Antakalnio g. 108,6065166,584743,Antakalnio,60,Kaštonas,11,Nuo 5 iki 7 metų,5,7,1,Lietuvių,,17,17,0,Lie,,17,0,0,0
66,Lakštingala,Lakštingalų g. 10,6066921,585208,Antakalnio,66,Lakštingala,8,Nuo 5 iki 6 metų,5,6,1,Lietuvių,1,47,49,-2,Lie,,47,0,-2,0
75,Molinukas,Keramikų g. 34,6066566,588317,Antakalnio,75,Molinukas,8,Nuo 5 iki 6 metų,5,6,1,Lietuvių,,21,21,0,Lie,,21,0,0,0
76,Naminukas,Smėlio g. 13,6064063,584574,Antakalnio,76,Naminukas,11,Nuo 5 iki 7 metų,5,7,1,Lietuvių,1,43,38,5,Lie,,43,0,5,0
95,Pušaitė,Bistryčios g. 3,6064071,584954,Antakalnio,95,Pušaitė,8,Nuo 5 iki 6 metų,5,6,1,Lietuvių,1,47,47,0,Lie,,47,0,0,0
127,Voveraitė,Jūratės g. 4A,6063156,584800,Antakalnio,127,Voveraitė,8,Nuo 5 iki 6 metų,5,6,1,Lietuvių,,21,21,0,Lie,,21,0,0,0
127,Voveraitė,Jūratės g. 4A,6063156,584800,Antakalnio,127,Voveraitė,11,Nuo 5 iki 7 metų,5,7,1,Lietuvių,,37,37,0,Lie,,37,0,0,0
138,Žolynėlis,Žolyno g. 44,6064324,586286,Antakalnio,138,Žolynėlis,8,Nuo 5 iki 6 metų,5,6,1,Lietuvių,,0,0,0,Lie,,0,0,0,0
181,Volungė,Volungės g. 10,6063735,585007,Antakalnio,181,Volungė,8,Nuo 5 iki 6 metų,5,6,1,Lietuvių,,43,43,0,Lie,,43,0,0,0
369,Vilniaus Joachimo Lelevelio inžinerijos mokykla,Minties g. 3,6064004,583703,Antakalnio,369,Vilniaus Joachimo Lelevelio inžinerijos mokykla,11,Nuo 5 iki 7 metų,5,7,4,Lenkų,6,0,7,-7,Len,,0,0,-7,0
369,Vilniaus Joachimo Lelevelio inžinerijos mokykla,Minties g. 3,6064004,583703,Antakalnio,369,Vilniaus Joachimo Lelevelio inžinerijos mokykla,11,Nuo 5 iki 7 metų,5,7,2,Rusų,6,0,0,0,Rus,,0,0,0,0
388,Žolynas,Žolyno g. 45A,6064325,586025,Antakalnio,388,Žolynas,11,Nuo 5 iki 7 metų,5,7,1,Lietuvių,,42,42,0,Lie,,42,0,0,0
87,Paslaptis,Darželio g. 7,6062328,591333,Naujosios Vilnios,87,Paslaptis,11,Nuo 5 iki 7 metų,5,7,2,Rusų,4,18,18,0,Rus,,18,0,0,0
108,Saulėtekis,Genių g. 12,6062344,591681,Naujosios Vilnios,108,Saulėtekis,8,Nuo 5 iki 6 metų,5,6,1,Lietuvių,1,58,57,1,Lie,,58,0,1,0
124,Vilnelė,Pergalės g. 20,6062147,591050,Naujosios Vilnios,124,Vilnelė,8,Nuo 5 iki 6 metų,5,6,1,Lietuvių,,42,41,1,Lie,,42,0,1,0
137,Žiogelis,J. Kolaso g. 15,6060159,587527,Naujosios Vilnios,137,Žiogelis,8,Nuo 5 iki 6 metų,5,6,1,Lietuvių,11,46,46,0,Lie,,46,0,0,0
139,Žuvėdra,Parko g. 8A,6062362,591153,Naujosios Vilnios,139,Žuvėdra,11,Nuo 5 iki 7 metų,5,7,2,Rusų,6,20,20,0,Rus,,20,0,0,0
171,Žaliakalnio,Pergalės g. 22,6062066,591084,Naujosios Vilnios,171,Žaliakalnio,8,Nuo 5 iki 6 metų,5,6,4,Lenkų,,21,21,0,Len,,21,0,0,0
63,Klevelis,Stadiono g. 5,6059967,583359,Rasų,63,Klevelis,11,Nuo 5 iki 7 metų,5,7,2,Rusų,,24,24,0,Rus,,24,0,0,0
72,Markučiai,Pakraščio g. 15,6060712,585088,Rasų,72,Markučiai,8,Nuo 5 iki 6 metų,5,6,1,Lietuvių,,22,20,2,Lie,,22,0,2,0
123,Vėtrungė,Gardino g. 8,6059622,583920,Rasų,123,Vėtrungė,8,Nuo 5 iki 6 metų,5,6,1,Lietuvių,1,25,25,0,Lie,,25,0,0,0
123,Vėtrungė,Gardino g. 8,6059622,583920,Rasų,123,Vėtrungė,11,Nuo 5 iki 7 metų,5,7,1,Lietuvių,1,11,10,1,Lie,,11,0,1,0
332,Vilniaus Liepkalnio Pagrindinė Mokykla,Liepkalnio g. 18,6059847,583697,Rasų,332,Vilniaus Liepkalnio Pagrindinė Mokykla,11,Nuo 5 iki 7 metų,5,7,2,Rusų,1,23,20,3,Rus,,23,0,3,0
56,Gudrutis,Trakų g. 12,6061176,582562,Senamiesčio,56,Gudrutis,8,Nuo 5 iki 6 metų,5,6,1,Lietuvių,2,26,24,2,Lie,,26,0,2,0
61,Krivūlė,Lydos g. 5,6060976,582608,Senamiesčio,61,Krivūlė,8,Nuo 5 iki 6 metų,5,6,1,Lietuvių,2,18,17,1,Lie,,18,0,1,0
61,Krivūlė,Lydos g. 5,6060976,582608,Senamiesčio,61,Krivūlė,11,Nuo 5 iki 7 metų,5,7,1,Lietuvių,4,14,14,0,Lie,,14,0,0,0
98,Rasa,M. Daukšos g. 15,6060531,583570,Senamiesčio,98,Rasa,8,Nuo 5 iki 6 metų,5,6,1,Lietuvių,1,56,56,0,Lie,,56,0,0,0
116,Šypsena,Povilo Višinskio g. 23,6060511,584155,Senamiesčio,116,Šypsena,8,Nuo 5 iki 6 metų,5,6,4,Lenkų,1,23,23,0,Len,,23,0,0,0
116,Šypsena,Povilo Višinskio g. 23,6060511,584155,Senamiesčio,116,Šypsena,11,Nuo 5 iki 7 metų,5,7,4,Lenkų,1,17,14,3,Len,,17,0,3,0
118,Užupiukas,Filaretų g. 19,6061661,584234,Senamiesčio,118,Užupiukas,8,Nuo 5 iki 6 metų,5,6,1,Lietuvių,5,45,42,3,Lie,,45,0,3,0
155,Gėlynas,Gėlių g. 9A,6060442,582724,Senamiesčio,155,Gėlynas,8,Nuo 5 iki 6 metų,5,6,1,Lietuvių,3,20,20,0,Lie,,20,0,0,0
34,Beržynėlis,Beržyno g. 7A,6061242,580943,Naujamiesčio,34,Beržynėlis,8,Nuo 5 iki 6 metų,5,6,1,Lietuvių,5,20,20,0,Lie,,20,0,0,0
44,Drevinukas,K. Donelaičio g. 12,6061130,580761,Naujamiesčio,44,Drevinukas,8,Nuo 5 iki 6 metų,5,6,1,Lietuvių,1,24,21,3,Lie,,24,0,3,0
44,Drevinukas,K. Donelaičio g. 12,6061130,580761,Naujamiesčio,44,Drevinukas,11,Nuo 5 iki 7 metų,5,7,1,Lietuvių,1,19,18,1,Lie,,19,0,1,0
50,Geniukų kalvė,Muitinės g. 30,6060904,581368,Naujamiesčio,50,Geniukų kalvė,8,Nuo 5 iki 6 metų,5,6,1,Lietuvių,2,67,65,2,Lie,,67,0,2,0
64,Kurpaitė,Birželio 23-iosios g. 6,6060317,581350,Naujamiesčio,64,Kurpaitė,11,Nuo 5 iki 7 metų,5,7,2,Rusų,,19,19,0,Rus,,19,0,0,0
65,Kūlverstukas,Suvalkų g. 6,6061494,581645,Naujamiesčio,65,Kūlverstukas,11,Nuo 5 iki 7 metų,5,7,2,Rusų,,21,21,0,Rus,,21,0,0,0
73,Mažylis,A. Vivulskio g. 8A,6060972,581880,Naujamiesčio,73,Mažylis,8,Nuo 5 iki 6 metų,5,6,1,Lietuvių,1,19,19,0,Lie,,19,0,0,0
81,Pagrandukas,Mindaugo g. 15A,6060779,582121,Naujamiesčio,81,Pagrandukas,8,Nuo 5 iki 6 metų,5,6,1,Lietuvių,1,29,25,4,Lie,,29,0,4,0
81,Pagrandukas,Mindaugo g. 15A,6060779,582121,Naujamiesčio,81,Pagrandukas,11,Nuo 5 iki 7 metų,5,7,1,Lietuvių,1,12,12,0,Lie,,12,0,0,0
104,Sadutė,Z. Sierakausko g. 28,6061537,581487,Naujamiesčio,104,Sadutė,8,Nuo 5 iki 6 metų,5,6,1,Lietuvių,1,45,44,1,Lie,,45,0,1,0
117,Šnekutis,Vytenio g. 41,6060541,581507,Naujamiesčio,117,Šnekutis,8,Nuo 5 iki 6 metų,5,6,1,Lietuvių,,35,35,0,Lie,,35,0,0,0
334,Vilniaus Simono Konarskio mokykla,Statybininkų g. 5,6060422,581103,Naujamiesčio,334,Vilniaus Simono Konarskio mokykla,11,Nuo 5 iki 7 metų,5,7,4,Lenkų,1,33,14,19,Len,,33,0,19,0
33,Aušrelė,Gerosios Vilties g. 28,6060144,580536,Vilkpėdės,33,Aušrelė,8,Nuo 5 iki 6 metų,5,6,1,Lietuvių,,41,41,0,Lie,,41,0,0,0
33,Aušrelė,Gerosios Vilties g. 28,6060144,580536,Vilkpėdės,33,Aušrelė,11,Nuo 5 iki 7 metų,5,7,1,Lietuvių,1,45,44,1,Lie,,45,0,1,0
109,Skroblinukas,Skroblų g. 13,6060044,580835,Vilkpėdės,109,Skroblinukas,8,Nuo 5 iki 6 metų,5,6,1,Lietuvių,1,46,46,0,Lie,,46,0,0,0
126,Viltenė,Gerosios Vilties g. 7A,6059971,580171,Vilkpėdės,126,Viltenė,8,Nuo 5 iki 6 metų,5,6,1,Lietuvių,,45,45,0,Lie,,45,0,0,0
149,Vaduvos,Vaduvos g. 14A,6056378,577898,Vilkpėdės,149,Vaduvos,8,Nuo 5 iki 6 metų,5,6,1,Lietuvių,1,43,41,2,Lie,,43,0,2,0
150,Vilkpėdės,Gerosios Vilties g. 15,6059880,580271,Vilkpėdės,150,Vilkpėdės,8,Nuo 5 iki 6 metų,5,6,1,Lietuvių,,23,22,1,Lie,,23,0,1,0
150,Vilkpėdės,Gerosios Vilties g. 15,6059880,580271,Vilkpėdės,150,Vilkpėdės,11,Nuo 5 iki 7 metų,5,7,1,Lietuvių,,30,28,2,Lie,,30,0,2,0
154,Bangelė,Žemaitės g. 3,6060388,580757,Vilkpėdės,154,Bangelė,11,Nuo 5 iki 7 metų,5,7,2,Rusų,1,24,19,5,Rus,,24,0,5,0
41,Daigelis,Dariaus ir Girėno g. 14,6059212,582247,Naujininkų,41,Daigelis,11,Nuo 5 iki 7 metų,5,7,2,Rusų,2,20,20,0,Rus,,20,0,0,0
46,Du gaideliai,Pelesos g. 15,6059555,582659,Naujininkų,46,Du gaideliai,11,Nuo 5 iki 7 metų,5,7,1,Lietuvių,3,22,21,1,Lie,,22,0,1,0
67,Lašelis,Dzūkų g. 29,6059341,582544,Naujininkų,67,Lašelis,11,Nuo 5 iki 7 metų,5,7,2,Rusų,,16,15,1,Rus,,16,0,1,0
69,Liepsnelė,Kapsų g. 7,6059010,582319,Naujininkų,69,Liepsnelė,11,Nuo 5 iki 7 metų,5,7,2,Rusų,2,21,21,0,Rus,,21,0,0,0
80,Pabiručiai,Brolių g. 18,6059283,581775,Naujininkų,80,Pabiručiai,8,Nuo 5 iki 6 metų,5,6,1,Lietuvių,,20,20,0,Lie,,20,0,0,0
106,Salininkų,Kalviškių g. 1,6052946,581325,Naujininkų,106,Salininkų,8,Nuo 5 iki 6 metų,5,6,1,Lietuvių,11,31,31,0,Lie,,31,0,0,0
130,Želmenėliai,Šaltkalvių g. 30,6058911,581955,Naujininkų,130,Želmenėliai,8,Nuo 5 iki 6 metų,5,6,1,Lietuvių,,19,19,0,Lie,,19,0,0,0
162,Šaltinėlis,Šaltkalvių g. 13,6059207,581916,Naujininkų,162,Šaltinėlis,8,Nuo 5 iki 6 metų,5,6,4,Lenkų,,23,23,0,Len,,23,0,0,0
162,Šaltinėlis,Šaltkalvių g. 13,6059207,581916,Naujininkų,162,Šaltinėlis,11,Nuo 5 iki 7 metų,5,7,4,Lenkų,,36,35,1,Len,,36,0,1,0
383,Vilniaus Saulėtekio mokykla-daugiafunkcinis centras,Kaminkelio g. 10,6058856,582305,Naujininkų,383,Vilniaus Saulėtekio mokykla-daugiafunkcinis centras,11,Nuo 5 iki 7 metų,5,7,2,Rusų,3,37,37,0,Rus,,37,0,0,0
128,Trakų Vokė,Eduardo Andrė g. 6,6055241,571717,Panerių,128,Trakų Vokė,8,Nuo 5 iki 6 metų,5,6,1,Lietuvių,7,23,22,1,Lie,,23,0,1,0
71,Lokiuko giraitė,Kovo 11-osios g. 54,6059688,571108,Grigiškių,71,Lokiuko giraitė,8,Nuo 5 iki 6 metų,5,6,1,Lietuvių,,41,41,0,Lie,,41,0,0,0
99,Rugelis,Kovo 11-osios g. 29A,6059755,570487,Grigiškių,99,Rugelis,8,Nuo 5 iki 6 metų,5,6,1,Lietuvių,,21,21,0,Lie,,21,0,0,0
144,Pelėdžiukas,Lentvario g. 1,6060250,569710,Grigiškių,144,Pelėdžiukas,8,Nuo 5 iki 6 metų,5,6,1,Lietuvių,5,23,23,0,Lie,,23,0,0,0
40,Čiauškutis,Sausio 13-osios g. 6,6062138,578557,Visos seniūnijos,40,Čiauškutis,8,Nuo 5 iki 6 metų,5,6,1,Lietuvių,1,27,27,0,Lie,,27,0,0,0
92,Prie pasakų parko,Loretos Asanavičiūtės g. 7,6061370,577417,Visos seniūnijos,92,Prie pasakų parko,11,Nuo 5 iki 7 metų,5,7,4,Lenkų,,9,5,4,Len,,9,0,4,0
189,VĮ Mažasis Trinapolis mok. 160 Eur,Trinapolio g. 11,6066065,583013,Visos seniūnijos,189,VĮ Mažasis Trinapolis mok. 160 Eur,8,Nuo 5 iki 6 metų,5,6,1,Lietuvių,,19,20,-1,Lie,,19,0,-1,0
54,Gintarėlis,Didlaukio g. 35,6066821,581859,Verkių,54,Gintarėlis,9,Nuo 6 iki 7 metų,6,7,1,Lietuvių,9,62,61,1,Lie,,62,0,1,0
115,Šermukšnėlė,Didlaukio g. 66,6066405,581924,Verkių,115,Šermukšnėlė,9,Nuo 6 iki 7 metų,6,7,1,Lietuvių,1,16,16,0,Lie,,16,0,0,0
273,Santariškių,Santariškių g. 27,6070076,582528,Verkių,273,Santariškių,9,Nuo 6 iki 7 metų,6,7,1,Lietuvių,62,67,66,1,Lie,,67,0,1,0
324,Vilniaus Baltupių progimnazija,Didlaukio g. 23,6066691,582037,Verkių,324,Vilniaus Baltupių progimnazija,9,Nuo 6 iki 7 metų,6,7,1,Lietuvių,9,38,38,0,Lie,,38,0,0,0
86,Pasaka,Žirmūnų g. 110,6066164,583842,Žirmūnų,86,Pasaka,9,Nuo 6 iki 7 metų,6,7,1,Lietuvių,1,31,31,0,Lie,,31,0,0,0
102,Ramunėlė,Žirmūnų g. 10,6063400,583684,Žirmūnų,102,Ramunėlė,9,Nuo 6 iki 7 metų,6,7,1,Lietuvių,2,44,44,0,Lie,,44,0,0,0
103,Rūta,Žirmūnų g. 50,6063864,583954,Žirmūnų,103,Rūta,9,Nuo 6 iki 7 metų,6,7,1,Lietuvių,,31,31,0,Lie,,31,0,0,0
110,Smalsučiai,Minties g. 40,6063682,583483,Žirmūnų,110,Smalsučiai,9,Nuo 6 iki 7 metų,6,7,1,Lietuvių,,33,33,0,Lie,,33,0,0,0
112,Spragtukas,Žirmūnų g. 108,6066278,583825,Žirmūnų,112,Spragtukas,9,Nuo 6 iki 7 metų,6,7,1,Lietuvių,,16,16,0,Lie,,16,0,0,0
112,Spragtukas,Žirmūnų g. 108,6066278,583825,Žirmūnų,112,Spragtukas,9,Nuo 6 iki 7 metų,6,7,2,Rusų,,26,25,1,Rus,,26,0,1,0
119,Vaidilutė,Rinktinės g. 29,6063132,583062,Žirmūnų,119,Vaidilutė,9,Nuo 6 iki 7 metų,6,7,1,Lietuvių,2,18,34,-16,Lie,,18,0,-16,0
141,Žirniukas,Verkių g. 17,6064137,582995,Žirmūnų,141,Žirniukas,9,Nuo 6 iki 7 metų,6,7,1,Lietuvių,1,42,42,0,Lie,,42,0,0,0
148,Vaivorykštė,Tuskulėnų g. 42,6063314,583236,Žirmūnų,148,Vaivorykštė,9,Nuo 6 iki 7 metų,6,7,2,Rusų,3,37,37,0,Rus,,37,0,0,0
158,Vieversys,Žirmūnų g. 89,6065626,584093,Žirmūnų,158,Vieversys,9,Nuo 6 iki 7 metų,6,7,1,Lietuvių,,62,62,0,Lie,,62,0,0,0
159,Žirmūnėliai,Žirmūnų g. 13,6064686,584179,Žirmūnų,159,Žirmūnėliai,9,Nuo 6 iki 7 metų,6,7,1,Lietuvių,,28,28,0,Lie,,28,0,0,0
312,Vilniaus Emilijos Pliaterytės progimnazija,Žirmūnų g. 119,6066489,584012,Žirmūnų,312,Vilniaus Emilijos Pliaterytės progimnazija,9,Nuo 6 iki 7 metų,6,7,1,Lietuvių,2,41,41,0,Lie,,41,0,0,0
327,Ąžuolas,Žirmūnų g. 32,6063664,583795,Žirmūnų,327,Ąžuolas,9,Nuo 6 iki 7 metų,6,7,1,Lietuvių,1,16,16,0,Lie,,16,0,0,0
45,Drugelis,Rinktinės g. 28A,6062920,582954,Šnipiškių,45,Drugelis,9,Nuo 6 iki 7 metų,6,7,1,Lietuvių,,21,21,0,Lie,,21,0,0,0
91,Pipiras,Krokuvos g. 6A,6062992,582810,Šnipiškių,91,Pipiras,9,Nuo 6 iki 7 metų,6,7,1,Lietuvių,,39,39,0,Lie,,39,0,0,0
140,Žvangutis,Rinktinės g. 38A,6063137,582826,Šnipiškių,140,Žvangutis,9,Nuo 6 iki 7 metų,6,7,1,Lietuvių,,12,12,0,Lie,,12,0,0,0
169,Švelnukas,Žalgirio g. 115,6063870,582480,Šnipiškių,169,Švelnukas,9,Nuo 6 iki 7 metų,6,7,1,Lietuvių,1,17,17,0,Lie,,17,0,0,0
339,Vilniaus Vladislavo Sirokomlės gimnazija,Linkmenų g. 8,6063489,581831,Šnipiškių,339,Vilniaus Vladislavo Sirokomlės gimnazija,9,Nuo 6 iki 7 metų,6,7,4,Lenkų,1,18,18,0,Len,,18,0,0,0
49,Gandriukas,Fabijoniškių g. 7,6065778,580283,Fabijoniškių,49,Gandriukas,9,Nuo 6 iki 7 metų,6,7,1,Lietuvių,15,77,77,0,Lie,,77,0,0,0
57,Jovarėlis,S. Stanevičiaus g. 21,6065899,580839,Fabijoniškių,57,Jovarėlis,9,Nuo 6 iki 7 metų,6,7,1,Lietuvių,,49,49,0,Lie,,49,0,0,0
59,Karusėlė,Gedvydžių g. 25,6067384,579862,Fabijoniškių,59,Karusėlė,9,Nuo 6 iki 7 metų,6,7,2,Rusų,,14,14,0,Rus,,14,0,0,0
105,Sakalėlis,S. Stanevičiaus g. 86,6066416,580734,Fabijoniškių,105,Sakalėlis,9,Nuo 6 iki 7 metų,6,7,1,Lietuvių,7,46,46,0,Lie,,46,0,0,0
120,Vandenis,P. Žadeikos g. 14A,6067055,579871,Fabijoniškių,120,Vandenis,9,Nuo 6 iki 7 metų,6,7,1,Lietuvių,8,69,68,1,Lie,,69,0,1,0
380,Vilniaus Ateities mokykla,S. Stanevičiaus g. 98,6066603,580657,Fabijoniškių,380,Vilniaus Ateities mokykla,9,Nuo 6 iki 7 metų,6,7,2,Rusų,2,37,37,0,Rus,,37,0,0,0
381,Vilniaus Simono Stanevičiaus progimnazija,S. Stanevičiaus g. 25,6065960,580945,Fabijoniškių,381,Vilniaus Simono Stanevičiaus progimnazija,9,Nuo 6 iki 7 metų,6,7,1,Lietuvių,2,78,78,0,Lie,,78,0,0,0
37,Bitutė,Paberžės g. 20,6065254,580866,Šeškinės,37,Bitutė,9,Nuo 6 iki 7 metų,6,7,1,Lietuvių,2,23,23,0,Lie,,23,0,0,0
51,Gelvonėlis,Gelvonų g. 1,6065015,581076,Šeškinės,51,Gelvonėlis,9,Nuo 6 iki 7 metų,6,7,1,Lietuvių,3,23,21,2,Lie,,23,0,2,0
62,Kodėlčiukas,Laisvės pr. 59,6065259,579457,Šeškinės,62,Kodėlčiukas,9,Nuo 6 iki 7 metų,6,7,1,Lietuvių,2,30,30,0,Lie,,30,0,0,0
79,Ozas,Gelvonų g. 24,6064973,580945,Šeškinės,79,Ozas,9,Nuo 6 iki 7 metų,6,7,1,Lietuvių,8,5,13,-8,Lie,,5,0,-8,0
84,Papartis,Čiobiškio g. 17,6065285,579915,Šeškinės,84,Papartis,9,Nuo 6 iki 7 metų,6,7,1,Lietuvių,,23,23,0,Lie,,23,0,0,0
89,Pelėda,Musninkų g. 10,6065012,579870,Šeškinės,89,Pelėda,9,Nuo 6 iki 7 metų,6,7,1,Lietuvių,7,50,50,0,Lie,,50,0,0,0
114,Sveikuolis,Dūkštų g. 14,6064690,580111,Šeškinės,114,Sveikuolis,9,Nuo 6 iki 7 metų,6,7,2,Rusų,,21,21,0,Rus,,21,0,0,0
121,Varpelis,Ukmergės g. 204,6064729,580302,Šeškinės,121,Varpelis,9,Nuo 6 iki 7 metų,6,7,1,Lietuvių,,28,28,0,Lie,,28,0,0,0
384,Vilniaus Maironio progimnazija,Čiobiškio g. 1,6064950,579723,Šeškinės,384,Vilniaus Maironio progimnazija,9,Nuo 6 iki 7 metų,6,7,1,Lietuvių,,23,22,1,Lie,,23,0,1,0
36,Birutės,Birutės g. 4,6061804,580647,Žvėryno,36,Birutės,9,Nuo 6 iki 7 metų,6,7,1,Lietuvių,4,19,19,0,Lie,,19,0,0,0
47,Eglutė,Miglos g. 3,6063700,580436,Žvėryno,47,Eglutė,9,Nuo 6 iki 7 metų,6,7,1,Lietuvių,2,71,71,0,Lie,,71,0,0,0
96,Pušynėlis,Miglos g. 53,6063459,580031,Žvėryno,96,Pušynėlis,9,Nuo 6 iki 7 metų,6,7,1,Lietuvių,3,22,21,1,Lie,,22,0,1,0
145,Saulutė,Miglos g. 1,6063793,580537,Žvėryno,145,Saulutė,9,Nuo 6 iki 7 metų,6,7,2,Rusų,6,20,20,0,Rus,,20,0,0,0
170,Boružėlė,Latvių g. 40,6062729,580386,Žvėryno,170,Boružėlė,9,Nuo 6 iki 7 metų,6,7,1,Lietuvių,26,38,38,0,Lie,,38,0,0,0
389,Vilniaus „Genio“ progimnazija,Miglos g. 1,6063793,580537,Žvėryno,389,Vilniaus „Genio“ progimnazija,9,Nuo 6 iki 7 metų,6,7,1,Lietuvių,14,35,42,-7,Lie,,35,0,-7,0
31,Aitvaras,Pašilaičių g. 10,6066674,579323,Pašilaičių,31,Aitvaras,9,Nuo 6 iki 7 metų,6,7,1,Lietuvių,1,22,21,1,Lie,,22,0,1,0
122,Vėjelis,Gabijos g. 21,6066861,578763,Pašilaičių,122,Vėjelis,9,Nuo 6 iki 7 metų,6,7,1,Lietuvių,1,22,22,0,Lie,,22,0,0,0
131,Žemyna,Žemynos g. 13,6066005,579220,Pašilaičių,131,Žemyna,9,Nuo 6 iki 7 metų,6,7,1,Lietuvių,3,83,79,4,Lie,,83,0,4,0
134,Žiedas,Žemynos g. 41,6066420,579182,Pašilaičių,134,Žiedas,9,Nuo 6 iki 7 metų,6,7,1,Lietuvių,3,16,16,0,Lie,,16,0,0,0
142,Aušra,Medeinos g. 5,6066482,578753,Pašilaičių,142,Aušra,9,Nuo 6 iki 7 metų,6,7,1,Lietuvių,7,27,29,-2,Lie,,27,0,-2,0
163,Gabijėlė,Gabijos g. 1,6066898,579033,Pašilaičių,163,Gabijėlė,9,Nuo 6 iki 7 metų,6,7,1,Lietuvių,18,66,66,0,Lie,,66,0,0,0
378,Vilniaus Aleksandro Puškino mokykla,Gabijos g. 8,6066745,578722,Pašilaičių,378,Vilniaus Aleksandro Puškino mokykla,9,Nuo 6 iki 7 metų,6,7,2,Rusų,2,44,44,0,Rus,,44,0,0,0
78,Nykštukas,Taikos g. 190,6064340,578266,Justiniškių,78,Nykštukas,9,Nuo 6 iki 7 metų,6,7,1,Lietuvių,1,61,61,0,Lie,,61,0,0,0
88,Pasakaitė,Taikos g. 30,6065571,578966,Justiniškių,88,Pasakaitė,9,Nuo 6 iki 7 metų,6,7,1,Lietuvių,,17,17,0,Lie,,17,0,0,0
136,Žilvinėlis,Taikos g. 130,6065108,578345,Justiniškių,136,Žilvinėlis,9,Nuo 6 iki 7 metų,6,7,1,Lietuvių,1,25,25,0,Lie,,25,0,0,0
164,Saulėgrąža,Taikos g. 31,6065577,579285,Justiniškių,164,Saulėgrąža,9,Nuo 6 iki 7 metų,6,7,1,Lietuvių,,30,27,3,Lie,,30,0,3,0
166,Vilija,Taikos g. 15,6065426,579249,Justiniškių,166,Vilija,9,Nuo 6 iki 7 metų,6,7,4,Lenkų,1,43,41,2,Len,,43,0,2,0
313,Vilniaus Taikos progimnazija,Taikos g. 157,6064995,578173,Justiniškių,313,Vilniaus Taikos progimnazija,9,Nuo 6 iki 7 metų,6,7,1,Lietuvių,1,92,91,1,Lie,,92,0,1,0
342,Vilniaus „Pelėdos” pradinė mokykla,Taikos g. 97,6065682,578130,Justiniškių,342,Vilniaus „Pelėdos” pradinė mokykla,9,Nuo 6 iki 7 metų,6,7,1,Lietuvių,4,93,92,1,Lie,,93,0,1,0
58,Jurginėlis,Justiniškių g. 47,6063867,578565,Viršuliškių,58,Jurginėlis,9,Nuo 6 iki 7 metų,6,7,1,Lietuvių,,31,31,0,Lie,,31,0,0,0
94,Puriena,Tujų g. 1,6063771,579356,Viršuliškių,94,Puriena,9,Nuo 6 iki 7 metų,6,7,1,Lietuvių,,48,48,0,Lie,,48,0,0,0
129,Zylutė,Justiniškių g. 45,6063900,578692,Viršuliškių,129,Zylutė,9,Nuo 6 iki 7 metų,6,7,1,Lietuvių,,18,18,0,Lie,,18,0,0,0
135,Žilvitis,Viršuliškių g. 9,6064823,579066,Viršuliškių,135,Žilvitis,9,Nuo 6 iki 7 metų,6,7,1,Lietuvių,,30,30,0,Lie,,30,0,0,0
331,Vilniaus Levo Karsavino vidurinė mokykla,Justiniškių g. 43,6063778,578576,Viršuliškių,331,Vilniaus Levo Karsavino vidurinė mokykla,9,Nuo 6 iki 7 metų,6,7,2,Rusų,1,50,50,0,Rus,,50,0,0,0
371,Vilniaus Jono Pauliaus II progimnazija,Rygos g. 10,6065110,578729,Viršuliškių,371,Vilniaus Jono Pauliaus II progimnazija,9,Nuo 6 iki 7 metų,6,7,4,Lenkų,1,91,89,2,Len,,91,0,2,0
74,Medynėlis,Algimanto Petro Kavoliuko g. 5,6062825,578008,Karoliniškių,74,Medynėlis,9,Nuo 6 iki 7 metų,6,7,1,Lietuvių,1,24,24,0,Lie,,24,0,0,0
97,Raktelis,Algimanto Petro Kavoliuko g. 12,6063038,578274,Karoliniškių,97,Raktelis,9,Nuo 6 iki 7 metų,6,7,4,Lenkų,,9,9,0,Len,,9,0,0,0
113,Strazdelis,Igno Šimulionio g. 14,6063215,579213,Karoliniškių,113,Strazdelis,9,Nuo 6 iki 7 metų,6,7,1,Lietuvių,1,28,23,5,Lie,,28,0,5,0
147,Šilelis,Sietyno g. 5,6061684,577294,Karoliniškių,147,Šilelis,9,Nuo 6 iki 7 metų,6,7,1,Lietuvių,,10,10,0,Lie,,10,0,0,0
151,Žiburėlis,Laisvės pr. 46,6063037,578464,Karoliniškių,151,Žiburėlis,9,Nuo 6 iki 7 metų,6,7,1,Lietuvių,1,18,18,0,Lie,,18,0,0,0
161,Lokiukas,Igno Šimulionio g. 8,6062788,578971,Karoliniškių,161,Lokiukas,9,Nuo 6 iki 7 metų,6,7,2,Rusų,,23,23,0,Rus,,23,0,0,0
338,Vilniaus „Spindulio“ progimnazija,Rolando Jankausko g. 17,6062339,577819,Karoliniškių,338,Vilniaus „Spindulio“ progimnazija,9,Nuo 6 iki 7 metų,6,7,1,Lietuvių,1,90,89,1,Lie,,90,0,1,0
55,Giraitė,Erfurto g. 42,6060492,577795,Lazdynų,55,Giraitė,9,Nuo 6 iki 7 metų,6,7,1,Lietuvių,,28,28,0,Lie,,28,0,0,0
82,Pakalnutė,Architektų g. 44,6060245,578504,Lazdynų,82,Pakalnutė,9,Nuo 6 iki 7 metų,6,7,1,Lietuvių,2,10,8,2,Lie,,10,0,2,0
100,Riešutėlis,Erfurto g. 21,6060722,577783,Lazdynų,100,Riešutėlis,9,Nuo 6 iki 7 metų,6,7,1,Lietuvių,2,38,38,0,Lie,,38,0,0,0
133,Žibutė,Architektų g. 62,6060142,578099,Lazdynų,133,Žibutė,9,Nuo 6 iki 7 metų,6,7,1,Lietuvių,,34,34,0,Lie,,34,0,0,0
146,Svaja,Architektų g. 210,6061055,578652,Lazdynų,146,Svaja,9,Nuo 6 iki 7 metų,6,7,2,Rusų,1,28,28,0,Rus,,28,0,0,0
156,Obelėlė,Architektų g. 204,6061258,578692,Lazdynų,156,Obelėlė,9,Nuo 6 iki 7 metų,6,7,1,Lietuvių,,56,56,0,Lie,,56,0,0,0
157,Spygliukas,Architektų g. 16,6060560,578449,Lazdynų,157,Spygliukas,9,Nuo 6 iki 7 metų,6,7,1,Lietuvių,,41,41,0,Lie,,41,0,0,0
53,Gilužis,Vydūno g. 11A,6063915,576329,Pilaitės,53,Gilužis,9,Nuo 6 iki 7 metų,6,7,1,Lietuvių,3,73,71,2,Lie,,73,0,2,0
165,Pilaitukas,I. Kanto al. 7A,6063638,576320,Pilaitės,165,Pilaitukas,9,Nuo 6 iki 7 metų,6,7,1,Lietuvių,15,49,48,1,Lie,,49,0,1,0
385,Vilniaus Martyno Mažvydo progimnazija,Vydūno g. 17A,6064020,576069,Pilaitės,385,Vilniaus Martyno Mažvydo progimnazija,9,Nuo 6 iki 7 metų,6,7,1,Lietuvių,13,44,44,0,Lie,,44,0,0,0
32,Atžalėlės,Antakalnio g. 74,6064495,584600,Antakalnio,32,Atžalėlės,9,Nuo 6 iki 7 metų,6,7,1,Lietuvių,,21,21,0,Lie,,21,0,0,0
66,Lakštingala,Lakštingalų g. 10,6066921,585208,Antakalnio,66,Lakštingala,9,Nuo 6 iki 7 metų,6,7,1,Lietuvių,,56,58,-2,Lie,,56,0,-2,0
75,Molinukas,Keramikų g. 34,6066566,588317,Antakalnio,75,Molinukas,9,Nuo 6 iki 7 metų,6,7,1,Lietuvių,4,18,18,0,Lie,,18,0,0,0
95,Pušaitė,Bistryčios g. 3,6064071,584954,Antakalnio,95,Pušaitė,9,Nuo 6 iki 7 metų,6,7,1,Lietuvių,,65,65,0,Lie,,65,0,0,0
127,Voveraitė,Jūratės g. 4A,6063156,584800,Antakalnio,127,Voveraitė,9,Nuo 6 iki 7 metų,6,7,1,Lietuvių,,23,23,0,Lie,,23,0,0,0
138,Žolynėlis,Žolyno g. 44,6064324,586286,Antakalnio,138,Žolynėlis,9,Nuo 6 iki 7 metų,6,7,1,Lietuvių,1,13,13,0,Lie,,13,0,0,0
138,Žolynėlis,Žolyno g. 44,6064324,586286,Antakalnio,138,Žolynėlis,15,Nuo 6 iki 8 metų,6,8,1,Lietuvių,1,5,5,0,Lie,,5,0,0,0
181,Volungė,Volungės g. 10,6063735,585007,Antakalnio,181,Volungė,9,Nuo 6 iki 7 metų,6,7,1,Lietuvių,1,35,35,0,Lie,,35,0,0,0
369,Vilniaus Joachimo Lelevelio inžinerijos mokykla,Minties g. 3,6064004,583703,Antakalnio,369,Vilniaus Joachimo Lelevelio inžinerijos mokykla,9,Nuo 6 iki 7 metų,6,7,4,Lenkų,3,9,9,0,Len,,9,0,0,0
369,Vilniaus Joachimo Lelevelio inžinerijos mokykla,Minties g. 3,6064004,583703,Antakalnio,369,Vilniaus Joachimo Lelevelio inžinerijos mokykla,9,Nuo 6 iki 7 metų,6,7,2,Rusų,3,14,13,1,Rus,,14,0,1,0
108,Saulėtekis,Genių g. 12,6062344,591681,Naujosios Vilnios,108,Saulėtekis,9,Nuo 6 iki 7 metų,6,7,1,Lietuvių,3,26,26,0,Lie,,26,0,0,0
108,Saulėtekis,Genių g. 12,6062344,591681,Naujosios Vilnios,108,Saulėtekis,9,Nuo 6 iki 7 metų,6,7,2,Rusų,3,9,9,0,Rus,,9,0,0,0
124,Vilnelė,Pergalės g. 20,6062147,591050,Naujosios Vilnios,124,Vilnelė,9,Nuo 6 iki 7 metų,6,7,1,Lietuvių,1,48,48,0,Lie,,48,0,0,0
137,Žiogelis,J. Kolaso g. 15,6060159,587527,Naujosios Vilnios,137,Žiogelis,9,Nuo 6 iki 7 metų,6,7,1,Lietuvių,3,37,37,0,Lie,,37,0,0,0
171,Žaliakalnio,Pergalės g. 22,6062066,591084,Naujosios Vilnios,171,Žaliakalnio,9,Nuo 6 iki 7 metų,6,7,4,Lenkų,,27,27,0,Len,,27,0,0,0
280,Vilnios pagrindinė mokykla,Palydovo g. 29A,6063647,591077,Naujosios Vilnios,280,Vilnios pagrindinė mokykla,9,Nuo 6 iki 7 metų,6,7,1,Lietuvių,1,31,20,11,Lie,,31,0,11,0
283,„Atžalyno” mokykla-darželis,Genių g. 25,6062220,591840,Naujosios Vilnios,283,„Atžalyno” mokykla-darželis,15,Nuo 6 iki 8 metų,6,8,1,Lietuvių,6,26,25,1,Lie,,26,0,1,0
72,Markučiai,Pakraščio g. 15,6060712,585088,Rasų,72,Markučiai,9,Nuo 6 iki 7 metų,6,7,1,Lietuvių,2,23,23,0,Lie,,23,0,0,0
123,Vėtrungė,Gardino g. 8,6059622,583920,Rasų,123,Vėtrungė,9,Nuo 6 iki 7 metų,6,7,1,Lietuvių,,12,12,0,Lie,,12,0,0,0
56,Gudrutis,Trakų g. 12,6061176,582562,Senamiesčio,56,Gudrutis,9,Nuo 6 iki 7 metų,6,7,1,Lietuvių,9,15,15,0,Lie,,15,0,0,0
61,Krivūlė,Lydos g. 5,6060976,582608,Senamiesčio,61,Krivūlė,9,Nuo 6 iki 7 metų,6,7,1,Lietuvių,2,32,30,2,Lie,,32,0,2,0
98,Rasa,M. Daukšos g. 15,6060531,583570,Senamiesčio,98,Rasa,9,Nuo 6 iki 7 metų,6,7,1,Lietuvių,2,34,30,4,Lie,,34,0,4,0
118,Užupiukas,Filaretų g. 19,6061661,584234,Senamiesčio,118,Užupiukas,9,Nuo 6 iki 7 metų,6,7,1,Lietuvių,3,29,29,0,Lie,,29,0,0,0
155,Gėlynas,Gėlių g. 9A,6060442,582724,Senamiesčio,155,Gėlynas,9,Nuo 6 iki 7 metų,6,7,1,Lietuvių,,18,18,0,Lie,,18,0,0,0
34,Beržynėlis,Beržyno g. 7A,6061242,580943,Naujamiesčio,34,Beržynėlis,9,Nuo 6 iki 7 metų,6,7,1,Lietuvių,2,10,10,0,Lie,,10,0,0,0
44,Drevinukas,K. Donelaičio g. 12,6061130,580761,Naujamiesčio,44,Drevinukas,9,Nuo 6 iki 7 metų,6,7,1,Lietuvių,,18,18,0,Lie,,18,0,0,0
50,Geniukų kalvė,Muitinės g. 30,6060904,581368,Naujamiesčio,50,Geniukų kalvė,9,Nuo 6 iki 7 metų,6,7,1,Lietuvių,4,48,48,0,Lie,,48,0,0,0
73,Mažylis,A. Vivulskio g. 8A,6060972,581880,Naujamiesčio,73,Mažylis,9,Nuo 6 iki 7 metų,6,7,1,Lietuvių,4,24,24,0,Lie,,24,0,0,0
104,Sadutė,Z. Sierakausko g. 28,6061537,581487,Naujamiesčio,104,Sadutė,9,Nuo 6 iki 7 metų,6,7,1,Lietuvių,1,28,28,0,Lie,,28,0,0,0
160,Dainorėliai,Ankštoji g. 11,6062282,581589,Naujamiesčio,160,Dainorėliai,9,Nuo 6 iki 7 metų,6,7,1,Lietuvių,1,25,24,1,Lie,,25,0,1,0
109,Skroblinukas,Skroblų g. 13,6060044,580835,Vilkpėdės,109,Skroblinukas,9,Nuo 6 iki 7 metų,6,7,1,Lietuvių,1,34,34,0,Lie,,34,0,0,0
126,Viltenė,Gerosios Vilties g. 7A,6059971,580171,Vilkpėdės,126,Viltenė,9,Nuo 6 iki 7 metų,6,7,1,Lietuvių,1,51,50,1,Lie,,51,0,1,0
149,Vaduvos,Vaduvos g. 14A,6056378,577898,Vilkpėdės,149,Vaduvos,9,Nuo 6 iki 7 metų,6,7,1,Lietuvių,1,44,42,2,Lie,,44,0,2,0
46,Du gaideliai,Pelesos g. 15,6059555,582659,Naujininkų,46,Du gaideliai,9,Nuo 6 iki 7 metų,6,7,1,Lietuvių,3,16,14,2,Lie,,16,0,2,0
52,Gervelė,Dzūkų g. 32,6059430,582938,Naujininkų,52,Gervelė,9,Nuo 6 iki 7 metų,6,7,1,Lietuvių,1,15,15,0,Lie,,15,0,0,0
67,Lašelis,Dzūkų g. 29,6059341,582544,Naujininkų,67,Lašelis,9,Nuo 6 iki 7 metų,6,7,2,Rusų,,5,5,0,Rus,,5,0,0,0
80,Pabiručiai,Brolių g. 18,6059283,581775,Naujininkų,80,Pabiručiai,9,Nuo 6 iki 7 metų,6,7,1,Lietuvių,1,22,18,4,Lie,,22,0,4,0
130,Želmenėliai,Šaltkalvių g. 30,6058911,581955,Naujininkų,130,Želmenėliai,9,Nuo 6 iki 7 metų,6,7,1,Lietuvių,,17,17,0,Lie,,17,0,0,0
311,Vilniaus Naujininkų mokykla,Šaltkalvių g. 32,6058943,581862,Naujininkų,311,Vilniaus Naujininkų mokykla,9,Nuo 6 iki 7 metų,6,7,1,Lietuvių,2,0,0,0,Lie,,0,0,0,0
337,Vilniaus Salininkų gimnazija,VAIKŲ G. 16,6053402,581401,Naujininkų,337,Vilniaus Salininkų gimnazija,9,Nuo 6 iki 7 metų,6,7,1,Lietuvių,1,46,45,1,Lie,,46,0,1,0
335,Vilniaus Trakų Vokės gimnazija,Trampolio g. 5,6055129,571743,Panerių,335,Vilniaus Trakų Vokės gimnazija,9,Nuo 6 iki 7 metų,6,7,1,Lietuvių,1,44,44,0,Lie,,44,0,0,0
71,Lokiuko giraitė,Kovo 11-osios g. 54,6059688,571108,Grigiškių,71,Lokiuko giraitė,9,Nuo 6 iki 7 metų,6,7,1,Lietuvių,,27,27,0,Lie,,27,0,0,0
99,Rugelis,Kovo 11-osios g. 29A,6059755,570487,Grigiškių,99,Rugelis,9,Nuo 6 iki 7 metų,6,7,1,Lietuvių,,16,15,1,Lie,,16,0,1,0
144,Pelėdžiukas,Lentvario g. 1,6060250,569710,Grigiškių,144,Pelėdžiukas,9,Nuo 6 iki 7 metų,6,7,1,Lietuvių,3,42,42,0,Lie,,42,0,0,0
40,Čiauškutis,Sausio 13-osios g. 6,6062138,578557,Visos seniūnijos,40,Čiauškutis,9,Nuo 6 iki 7 metų,6,7,1,Lietuvių,,51,50,1,Lie,,51,0,1,0
92,Prie pasakų parko,Loretos Asanavičiūtės g. 7,6061370,577417,Visos seniūnijos,92,Prie pasakų parko,9,Nuo 6 iki 7 metų,6,7,2,Rusų,,15,12,3,Rus,,15,0,3,0
189,VĮ Mažasis Trinapolis mok. 160 Eur,Trinapolio g. 11,6066065,583013,Visos seniūnijos,189,VĮ Mažasis Trinapolis mok. 160 Eur,9,Nuo 6 iki 7 metų,6,7,1,Lietuvių,,21,21,0,Lie,,21,0,0,0
153,Aidas,Lakštingalų g. 8,6066829,585334,Visos seniūnijos,153,Aidas,45,Nuo 8m.,8,99.99,1,Lietuvių,1,72,72,0,Lie,,72,0,0,0
